,yr_range,sec_unique,year1,year2,n2_inflow,agi_inflow,n2_outflow,agi_outflow,n2_net,agi_net
0,1516,"Ada County, ID",2015,2016,1030,27990000,1023,31110000,7,-3120000
1,1516,"Alameda County, CA",2015,2016,1445,68539000,528,23465000,917,45074000
2,1516,"Allegheny County, PA",2015,2016,125,5911000,91,2839000,34,3072000
3,1516,"Anchorage Municipality, AK",2015,2016,346,12294000,204,5574000,142,6720000
4,1516,"Arapahoe County, CO",2015,2016,136,4030000,120,3670000,16,360000
5,1516,"Bernalillo County, NM",2015,2016,254,8154000,116,4027000,138,4127000
6,1516,"Bexar County, TX",2015,2016,146,4763000,125,4537000,21,226000
7,1516,"Boulder County, CO",2015,2016,116,5899000,56,2145000,60,3754000
8,1516,"Buncombe County, NC",2015,2016,54,1379000,32,1438000,22,-59000
9,1516,"Canyon County, ID",2015,2016,326,4461000,357,6884000,-31,-2423000
10,1516,"Chittenden County, VT",2015,2016,56,1925000,48,1635000,8,290000
11,1516,"Clark County, NV",2015,2016,1497,37963000,1083,35683000,414,2280000
12,1516,"Clark County, WA",2015,2016,6703,195802000,10999,322156000,-4296,-126354000
13,1516,"Collin County, TX",2015,2016,69,2524000,120,3768000,-51,-1244000
14,1516,"Contra Costa County, CA",2015,2016,699,44730000,285,11157000,414,33573000
15,1516,"Cook County, IL",2015,2016,823,39845000,337,15273000,486,24572000
16,1516,"Cowlitz County, WA",2015,2016,493,12219000,806,17358000,-313,-5139000
17,1516,"Cumberland County, ME",2015,2016,44,1322000,37,1344000,7,-22000
18,1516,"Dallas County, TX",2015,2016,286,12432000,168,7620000,118,4812000
19,1516,"Dane County, WI",2015,2016,96,3401000,40,1736000,56,1665000
20,1516,"Davidson County, TN",2015,2016,88,3988000,62,2052000,26,1936000
21,1516,"Davis County, UT",2015,2016,71,1681000,61,1768000,10,-87000
22,1516,"DeKalb County, GA",2015,2016,60,2503000,29,795000,31,1708000
23,1516,"Del Norte County, CA",2015,2016,108,3406000,91,1639000,17,1767000
24,1516,"Denver County, CO",2015,2016,294,13183000,223,10970000,71,2213000
25,1516,"District of Columbia, DC",2015,2016,166,10064000,76,5880000,90,4184000
26,1516,"El Paso County, CO",2015,2016,163,4778000,106,3710000,57,1068000
27,1516,"Fairfax County, VA",2015,2016,85,4500000,53,1609000,32,2891000
28,1516,"Franklin County, OH",2015,2016,144,5966000,141,2955000,3,3011000
29,1516,"Franklin County, WA",2015,2016,79,929000,157,4067000,-78,-3138000
30,1516,"Fresno County, CA",2015,2016,100,2770000,73,1176000,27,1594000
31,1516,"Fulton County, GA",2015,2016,91,4744000,41,3296000,50,1448000
32,1516,"Gallatin County, MT",2015,2016,31,1240000,31,1591000,0,-351000
33,1516,"Harris County, TX",2015,2016,453,19848000,250,7269000,203,12579000
34,1516,"Hawaii County, HI",2015,2016,106,3746000,123,4654000,-17,-908000
35,1516,"Hennepin County, MN",2015,2016,326,16083000,188,6028000,138,10055000
36,1516,"Hillsborough County, FL",2015,2016,59,2022000,47,708000,12,1314000
37,1516,"Honolulu County, HI",2015,2016,754,23040000,328,9153000,426,13887000
38,1516,"Humboldt County, CA",2015,2016,141,3496000,62,1488000,79,2008000
39,1516,"Kern County, CA",2015,2016,80,3075000,45,929000,35,2146000
40,1516,"King County, WA",2015,2016,3208,154521000,3089,130740000,119,23781000
41,1516,"Kings County, NY",2015,2016,478,27133000,191,8623000,287,18510000
42,1516,"Kitsap County, WA",2015,2016,251,8629000,231,7898000,20,731000
43,1516,"Klickitat County, WA",2015,2016,240,5736000,370,13445000,-130,-7709000
44,1516,"Knox County, TN",2015,2016,29,1817000,39,1443000,-10,374000
45,1516,"Kootenai County, ID",2015,2016,81,1912000,108,2242000,-27,-330000
46,1516,"Larimer County, CO",2015,2016,55,1629000,38,1346000,17,283000
47,1516,"Los Angeles County, CA",2015,2016,4255,177112000,1694,55276000,2561,121836000
48,1516,"Maricopa County, AZ",2015,2016,2679,92635000,2235,80190000,444,12445000
49,1516,"Marin County, CA",2015,2016,128,8962000,48,2945000,80,6017000
50,1516,"Maui County, HI",2015,2016,46,2234000,56,2041000,-10,193000
51,1516,"Mecklenburg County, NC",2015,2016,69,3624000,36,1160000,33,2464000
52,1516,"Miami, Dade County",2015,2016,131,3992000,115,3527000,16,465000
53,1516,"Middlesex County, MA",2015,2016,316,23792000,161,9013000,155,14779000
54,1516,"Milwaukee County, WI",2015,2016,82,2735000,31,842000,51,1893000
55,1516,"Missoula County, MT",2015,2016,69,1682000,75,2078000,-6,-396000
56,1516,"Monterey County, CA",2015,2016,120,3912000,66,2665000,54,1247000
57,1516,"Montgomery County, MD",2015,2016,104,5602000,42,1858000,62,3744000
58,1516,"New Haven County, CT",2015,2016,51,1777000,23,833000,28,944000
59,1516,"New York County, NY",2015,2016,246,17226000,132,10880000,114,6346000
60,1516,"Oakland County, MI",2015,2016,48,1403000,41,1484000,7,-81000
61,1516,"Orange County, CA",2015,2016,1832,65108000,669,33370000,1163,31738000
62,1516,"Orange County, FL",2015,2016,103,3506000,85,2664000,18,842000
63,1516,"Orleans Parish, LA",2015,2016,78,2580000,44,1878000,34,702000
64,1516,"Pacific County, WA",2015,2016,94,2214000,122,3491000,-28,-1277000
65,1516,"Palm Beach County, FL",2015,2016,49,3257000,43,1226000,6,2031000
66,1516,"Payette County, ID",2015,2016,331,3850000,320,5756000,11,-1906000
67,1516,"Philadelphia County, PA",2015,2016,118,5893000,61,1879000,57,4014000
68,1516,"Pierce County, WA",2015,2016,1035,30327000,1027,29765000,8,562000
69,1516,"Pima County, AZ",2015,2016,457,14429000,425,17755000,32,-3326000
70,1516,"Pinal County, AZ",2015,2016,60,1592000,53,2318000,7,-726000
71,1516,"Pinellas County, FL",2015,2016,62,2232000,36,1024000,26,1208000
72,1516,"Placer County, CA",2015,2016,108,4737000,91,3630000,17,1107000
73,1516,"Queens County, NY",2015,2016,99,4576000,34,1351000,65,3225000
74,1516,"Ramsey County, MN",2015,2016,65,4185000,38,1444000,27,2741000
75,1516,"Riverside County, CA",2015,2016,961,23657000,576,17410000,385,6247000
76,1516,"Sacramento County, CA",2015,2016,735,27280000,498,15456000,237,11824000
77,1516,"Salt Lake County, UT",2015,2016,574,17401000,416,11830000,158,5571000
78,1516,"San Bernardino County, CA",2015,2016,493,11806000,265,6570000,228,5236000
79,1516,"San Diego County, CA",2015,2016,2458,84565000,1220,40300000,1238,44265000
80,1516,"San Francisco County, CA",2015,2016,1177,101594000,285,19989000,892,81605000
81,1516,"San Luis Obispo County, CA",2015,2016,74,2838000,41,1389000,33,1449000
82,1516,"San Mateo County, CA",2015,2016,463,33740000,117,9700000,346,24040000
83,1516,"Santa Barbara County, CA",2015,2016,117,4765000,44,1348000,73,3417000
84,1516,"Santa Clara County, CA",2015,2016,1576,106828000,683,48827000,893,58001000
85,1516,"Santa Cruz County, CA",2015,2016,123,4354000,35,1071000,88,3283000
86,1516,"Santa Fe County, NM",2015,2016,45,1608000,34,1094000,11,514000
87,1516,"Shasta County, CA",2015,2016,221,5447000,90,1507000,131,3940000
88,1516,"Siskiyou County, CA",2015,2016,235,4215000,170,3338000,65,877000
89,1516,"Skamania County, WA",2015,2016,49,1079000,81,2557000,-32,-1478000
90,1516,"Snohomish County, WA",2015,2016,603,18489000,743,23574000,-140,-5085000
91,1516,"Solano County, CA",2015,2016,45,1550000,40,820000,5,730000
92,1516,"Sonoma County, CA",2015,2016,385,12907000,186,5612000,199,7295000
93,1516,"Spokane County, WA",2015,2016,626,16395000,738,20539000,-112,-4144000
94,1516,"Suffolk County, MA",2015,2016,114,6773000,62,2727000,52,4046000
95,1516,"Tarrant County, TX",2015,2016,133,4127000,163,4462000,-30,-335000
96,1516,"Thurston County, WA",2015,2016,486,16407000,487,14065000,-1,2342000
97,1516,"Travis County, TX",2015,2016,840,30771000,402,15802000,438,14969000
98,1516,"Utah County, UT",2015,2016,201,4413000,193,4284000,8,129000
99,1516,"Ventura County, CA",2015,2016,322,10778000,112,3378000,210,7400000
100,1516,"Walla Walla County, WA",2015,2016,339,5524000,371,6891000,-32,-1367000
101,1516,"Washoe County, NV",2015,2016,381,11635000,269,8012000,112,3623000
102,1516,"Washtenaw County, MI",2015,2016,71,2602000,34,1220000,37,1382000
103,1516,"Westchester County, NY",2015,2016,34,3240000,31,2173000,3,1067000
104,1516,"Whatcom County, WA",2015,2016,136,3132000,170,5017000,-34,-1885000
105,1516,"Williamson County, TX",2015,2016,49,2439000,127,5354000,-78,-2915000
106,1516,"Yakima County, WA",2015,2016,186,4679000,243,4550000,-57,129000
107,1516,"Yavapai County, AZ",2015,2016,29,1104000,30,1081000,-1,23000
108,1617,"Ada County, ID",2016,2017,1213,34727000,1956,67017000,-743,-32290000
109,1617,"Adams County, CO",2016,2017,51,2858000,33,1470000,18,1388000
110,1617,"Alameda County, CA",2016,2017,1911,109187000,672,36432000,1239,72755000
111,1617,"Allegheny County, PA",2016,2017,163,7195000,131,6939000,32,256000
112,1617,"Anchorage Municipality, AK",2016,2017,438,14552000,218,7394000,220,7158000
113,1617,"Arapahoe County, CO",2016,2017,223,8698000,185,6685000,38,2013000
114,1617,"Arlington County, VA",2016,2017,73,5175000,32,2204000,41,2971000
115,1617,"Baltimore city, MD",2016,2017,85,4212000,57,2739000,28,1473000
116,1617,"Bernalillo County, NM",2016,2017,296,12016000,158,5296000,138,6720000
117,1617,"Bexar County, TX",2016,2017,274,9975000,207,5907000,67,4068000
118,1617,"Boulder County, CO",2016,2017,250,10840000,237,8673000,13,2167000
119,1617,"Broward County, FL",2016,2017,83,4646000,50,2367000,33,2279000
120,1617,"Buncombe County, NC",2016,2017,53,1514000,57,2265000,-4,-751000
121,1617,"Butte County, CA",2016,2017,125,3668000,100,2234000,25,1434000
122,1617,"Canyon County, ID",2016,2017,454,7028000,576,12201000,-122,-5173000
123,1617,"Charleston County, SC",2016,2017,58,2590000,30,1190000,28,1400000
124,1617,"Chittenden County, VT",2016,2017,54,2105000,48,1414000,6,691000
125,1617,"Clark County, NV",2016,2017,1932,55156000,1713,51867000,219,3289000
126,1617,"Clark County, WA",2016,2017,8102,250960000,14507,506336000,-6405,-255376000
127,1617,"Coconino County, AZ",2016,2017,59,1541000,31,784000,28,757000
128,1617,"Collin County, TX",2016,2017,155,8675000,230,9895000,-75,-1220000
129,1617,"Contra Costa County, CA",2016,2017,1113,48311000,375,18294000,738,30017000
130,1617,"Cook County, IL",2016,2017,1150,61680000,510,22884000,640,38796000
131,1617,"Cowlitz County, WA",2016,2017,753,18271000,1328,32359000,-575,-14088000
132,1617,"Cumberland County, ME",2016,2017,44,3210000,66,2386000,-22,824000
133,1617,"Cuyahoga County, OH",2016,2017,139,4816000,107,3653000,32,1163000
134,1617,"Dallas County, TX",2016,2017,395,20362000,272,11634000,123,8728000
135,1617,"Dane County, WI",2016,2017,136,7065000,129,3972000,7,3093000
136,1617,"Davidson County, TN",2016,2017,137,6237000,125,4517000,12,1720000
137,1617,"DeKalb County, GA",2016,2017,76,3014000,70,3101000,6,-87000
138,1617,"Del Norte County, CA",2016,2017,99,2141000,114,2129000,-15,12000
139,1617,"Denton County, TX",2016,2017,69,3001000,76,3221000,-7,-220000
140,1617,"Denver County, CO",2016,2017,487,24514000,409,18772000,78,5742000
141,1617,"District of Columbia, DC",2016,2017,281,18272000,149,7030000,132,11242000
142,1617,"DuPage County, IL",2016,2017,105,3911000,95,4248000,10,-337000
143,1617,"Durham County, NC",2016,2017,42,1781000,54,2344000,-12,-563000
144,1617,"Duval County, FL",2016,2017,110,3275000,97,4453000,13,-1178000
145,1617,"El Paso County, CO",2016,2017,281,8213000,298,7476000,-17,737000
146,1617,"Erie County, NY",2016,2017,34,1168000,33,800000,1,368000
147,1617,"Fairfax County, VA",2016,2017,197,11652000,107,4135000,90,7517000
148,1617,"Franklin County, OH",2016,2017,203,8646000,160,4648000,43,3998000
149,1617,"Franklin County, WA",2016,2017,65,1073000,139,2291000,-74,-1218000
150,1617,"Fresno County, CA",2016,2017,258,7514000,136,4221000,122,3293000
151,1617,"Fulton County, GA",2016,2017,169,9046000,129,7225000,40,1821000
152,1617,"Gallatin County, MT",2016,2017,94,2611000,111,2674000,-17,-63000
153,1617,"Greene County, MO",2016,2017,32,867000,51,1092000,-19,-225000
154,1617,"Hamilton County, OH",2016,2017,60,3726000,49,1392000,11,2334000
155,1617,"Hampshire County, MA",2016,2017,42,1356000,42,2205000,0,-849000
156,1617,"Harris County, TX",2016,2017,501,24875000,433,11622000,68,13253000
157,1617,"Hartford County, CT",2016,2017,41,2121000,27,387000,14,1734000
158,1617,"Hawaii County, HI",2016,2017,177,4997000,227,7134000,-50,-2137000
159,1617,"Hennepin County, MN",2016,2017,414,17614000,365,17039000,49,575000
160,1617,"Hillsborough County, FL",2016,2017,130,4178000,108,3018000,22,1160000
161,1617,"Honolulu County, HI",2016,2017,1075,39622000,481,15533000,594,24089000
162,1617,"Hudson County, NJ",2016,2017,56,3543000,36,1746000,20,1797000
163,1617,"Humboldt County, CA",2016,2017,274,8427000,113,2755000,161,5672000
164,1617,"Island County, WA",2016,2017,35,974000,52,1120000,-17,-146000
165,1617,"Johnson County, KS",2016,2017,52,2203000,56,2364000,-4,-161000
166,1617,"Kent County, MI",2016,2017,45,2224000,44,1589000,1,635000
167,1617,"Kern County, CA",2016,2017,238,6037000,137,2386000,101,3651000
168,1617,"King County, WA",2016,2017,4716,228867000,4222,205157000,494,23710000
169,1617,"Kings County, NY",2016,2017,563,36493000,342,16522000,221,19971000
170,1617,"Kitsap County, WA",2016,2017,347,10358000,340,11341000,7,-983000
171,1617,"Klickitat County, WA",2016,2017,357,12123000,483,15440000,-126,-3317000
172,1617,"Kootenai County, ID",2016,2017,87,2264000,125,3437000,-38,-1173000
173,1617,"Larimer County, CO",2016,2017,139,5675000,139,4412000,0,1263000
174,1617,"Los Angeles County, CA",2016,2017,5773,241181000,2381,99098000,3392,142083000
175,1617,"Maricopa County, AZ",2016,2017,3878,144004000,4086,153865000,-208,-9861000
176,1617,"Marin County, CA",2016,2017,145,9063000,76,3514000,69,5549000
177,1617,"Maui County, HI",2016,2017,79,2634000,62,2417000,17,217000
178,1617,"Mecklenburg County, NC",2016,2017,114,5812000,125,4793000,-11,1019000
179,1617,"Miami, Dade County",2016,2017,153,5313000,123,5186000,30,127000
180,1617,"Middlesex County, MA",2016,2017,319,20420000,253,15011000,66,5409000
181,1617,"Milwaukee County, WI",2016,2017,112,3866000,55,1797000,57,2069000
182,1617,"Missoula County, MT",2016,2017,156,3580000,169,4831000,-13,-1251000
183,1617,"Mohave County, AZ",2016,2017,56,1005000,46,921000,10,84000
184,1617,"Monroe County, NY",2016,2017,46,1782000,50,1660000,-4,122000
185,1617,"Monterey County, CA",2016,2017,140,5471000,103,3489000,37,1982000
186,1617,"Montgomery County, MD",2016,2017,95,4893000,50,1800000,45,3093000
187,1617,"New Haven County, CT",2016,2017,62,2601000,58,2049000,4,552000
188,1617,"New York County, NY",2016,2017,377,34752000,185,13359000,192,21393000
189,1617,"Norfolk County, MA",2016,2017,74,5075000,35,3706000,39,1369000
190,1617,"Oakland County, MI",2016,2017,131,5820000,113,4439000,18,1381000
191,1617,"Oklahoma County, OK",2016,2017,53,1391000,35,1301000,18,90000
192,1617,"Onondaga County, NY",2016,2017,34,1369000,29,1096000,5,273000
193,1617,"Orange County, CA",2016,2017,2790,119014000,1024,42193000,1766,76821000
194,1617,"Orange County, FL",2016,2017,166,7189000,145,5796000,21,1393000
195,1617,"Orange County, NC",2016,2017,47,2160000,38,1367000,9,793000
196,1617,"Orleans Parish, LA",2016,2017,59,2399000,84,2451000,-25,-52000
197,1617,"Pacific County, WA",2016,2017,143,2468000,200,5287000,-57,-2819000
198,1617,"Palm Beach County, FL",2016,2017,80,2873000,55,1964000,25,909000
199,1617,"Payette County, ID",2016,2017,412,5068000,320,5705000,92,-637000
200,1617,"Philadelphia County, PA",2016,2017,129,6449000,113,4445000,16,2004000
201,1617,"Pierce County, WA",2016,2017,1464,49705000,1418,45737000,46,3968000
202,1617,"Pima County, AZ",2016,2017,719,20480000,747,29982000,-28,-9502000
203,1617,"Pinal County, AZ",2016,2017,62,1552000,101,4572000,-39,-3020000
204,1617,"Pinellas County, FL",2016,2017,54,2764000,85,3043000,-31,-279000
205,1617,"Placer County, CA",2016,2017,322,12336000,278,11678000,44,658000
206,1617,"Providence County, RI",2016,2017,48,2337000,53,2073000,-5,264000
207,1617,"Queens County, NY",2016,2017,105,4714000,30,1256000,75,3458000
208,1617,"Ramsey County, MN",2016,2017,79,2883000,67,1933000,12,950000
209,1617,"Riverside County, CA",2016,2017,1475,44131000,861,31777000,614,12354000
210,1617,"Sacramento County, CA",2016,2017,1364,47979000,858,26392000,506,21587000
211,1617,"Salt Lake County, UT",2016,2017,977,33045000,719,24110000,258,8935000
212,1617,"San Bernardino County, CA",2016,2017,898,25707000,339,8265000,559,17442000
213,1617,"San Diego County, CA",2016,2017,3272,118500000,1801,65768000,1471,52732000
214,1617,"San Francisco County, CA",2016,2017,1408,116622000,461,31053000,947,85569000
215,1617,"San Joaquin County, CA",2016,2017,83,2303000,38,585000,45,1718000
216,1617,"San Luis Obispo County, CA",2016,2017,163,4615000,83,2554000,80,2061000
217,1617,"San Mateo County, CA",2016,2017,648,45673000,167,10578000,481,35095000
218,1617,"Sandoval County, NM",2016,2017,77,3649000,45,2312000,32,1337000
219,1617,"Santa Barbara County, CA",2016,2017,255,10370000,111,6177000,144,4193000
220,1617,"Santa Clara County, CA",2016,2017,2760,194550000,1182,86935000,1578,107615000
221,1617,"Santa Cruz County, CA",2016,2017,131,5686000,63,2749000,68,2937000
222,1617,"Santa Fe County, NM",2016,2017,51,2545000,64,2423000,-13,122000
223,1617,"Saratoga County, NY",2016,2017,56,2968000,66,3938000,-10,-970000
224,1617,"Shasta County, CA",2016,2017,466,11263000,319,7045000,147,4218000
225,1617,"Shelby County, TN",2016,2017,53,2121000,30,1030000,23,1091000
226,1617,"Siskiyou County, CA",2016,2017,347,7779000,193,2953000,154,4826000
227,1617,"Snohomish County, WA",2016,2017,1085,38890000,935,29814000,150,9076000
228,1617,"Solano County, CA",2016,2017,112,3747000,81,2448000,31,1299000
229,1617,"Sonoma County, CA",2016,2017,531,18776000,249,6955000,282,11821000
230,1617,"Spokane County, WA",2016,2017,781,23006000,1149,34324000,-368,-11318000
231,1617,"St. Louis County, MO",2016,2017,129,4448000,103,3656000,26,792000
232,1617,"St. Louis city, MO",2016,2017,69,2690000,36,1503000,33,1187000
233,1617,"Suffolk County, MA",2016,2017,148,10323000,82,6898000,66,3425000
234,1617,"Tarrant County, TX",2016,2017,195,6814000,224,6748000,-29,66000
235,1617,"Thurston County, WA",2016,2017,638,22962000,698,22493000,-60,469000
236,1617,"Travis County, TX",2016,2017,798,35019000,659,35676000,139,-657000
237,1617,"Utah County, UT",2016,2017,324,6579000,321,7849000,3,-1270000
238,1617,"Ventura County, CA",2016,2017,314,11738000,151,4730000,163,7008000
239,1617,"Wake County, NC",2016,2017,189,7429000,188,8801000,1,-1372000
240,1617,"Walla Walla County, WA",2016,2017,426,10043000,570,12605000,-144,-2562000
241,1617,"Washoe County, NV",2016,2017,699,23158000,550,17246000,149,5912000
242,1617,"Washtenaw County, MI",2016,2017,87,4278000,61,2403000,26,1875000
243,1617,"Wayne County, MI",2016,2017,40,2419000,55,1621000,-15,798000
244,1617,"Whatcom County, WA",2016,2017,199,5791000,248,9067000,-49,-3276000
245,1617,"Williamson County, TX",2016,2017,121,4511000,197,10162000,-76,-5651000
246,1617,"Yakima County, WA",2016,2017,298,7345000,268,5573000,30,1772000
247,1617,"Yavapai County, AZ",2016,2017,175,5376000,200,6560000,-25,-1184000
248,1617,"Yellowstone County, MT",2016,2017,45,1670000,49,1194000,-4,476000
249,1617,"Yolo County, CA",2016,2017,60,1848000,36,1279000,24,569000
250,1718,"Ada County, ID",2017,2018,830,22187000,1264,44888000,-434,-22701000
251,1718,"Adams County, CO",2017,2018,31,832000,26,947000,5,-115000
252,1718,"Alameda County, CA",2017,2018,1456,87511000,584,28893000,872,58618000
253,1718,"Allegheny County, PA",2017,2018,58,3026000,57,2281000,1,745000
254,1718,"Anchorage Municipality, AK",2017,2018,263,10026000,171,5735000,92,4291000
255,1718,"Arapahoe County, CO",2017,2018,122,3551000,160,5287000,-38,-1736000
256,1718,"Baltimore city, MD",2017,2018,50,3132000,43,2084000,7,1048000
257,1718,"Bernalillo County, NM",2017,2018,147,6457000,191,6799000,-44,-342000
258,1718,"Bexar County, TX",2017,2018,195,7980000,153,5590000,42,2390000
259,1718,"Boulder County, CO",2017,2018,76,2684000,69,3106000,7,-422000
260,1718,"Broward County, FL",2017,2018,56,2726000,48,1547000,8,1179000
261,1718,"Butte County, CA",2017,2018,118,3552000,87,2562000,31,990000
262,1718,"Canyon County, ID",2017,2018,369,6961000,471,10780000,-102,-3819000
263,1718,"Chittenden County, VT",2017,2018,43,1284000,32,885000,11,399000
264,1718,"Clark County, NV",2017,2018,1253,37776000,1435,48555000,-182,-10779000
265,1718,"Clark County, WA",2017,2018,6566,246486000,10065,370489000,-3499,-124003000
266,1718,"Collin County, TX",2017,2018,117,5434000,140,5878000,-23,-444000
267,1718,"Contra Costa County, CA",2017,2018,674,38661000,342,16315000,332,22346000
268,1718,"Cook County, IL",2017,2018,778,39194000,418,20387000,360,18807000
269,1718,"Cowlitz County, WA",2017,2018,567,12583000,915,27653000,-348,-15070000
270,1718,"Cumberland County, ME",2017,2018,36,1547000,40,2010000,-4,-463000
271,1718,"Cuyahoga County, OH",2017,2018,42,2043000,55,2097000,-13,-54000
272,1718,"Dallas County, TX",2017,2018,247,11125000,205,7807000,42,3318000
273,1718,"Dane County, WI",2017,2018,96,4349000,61,2451000,35,1898000
274,1718,"Davidson County, TN",2017,2018,95,5201000,61,2133000,34,3068000
275,1718,"DeKalb County, GA",2017,2018,50,2375000,36,1455000,14,920000
276,1718,"Del Norte County, CA",2017,2018,81,1622000,55,1415000,26,207000
277,1718,"Denver County, CO",2017,2018,293,14777000,335,16999000,-42,-2222000
278,1718,"District of Columbia, DC",2017,2018,134,12170000,82,4448000,52,7722000
279,1718,"DuPage County, IL",2017,2018,46,1798000,37,1357000,9,441000
280,1718,"El Paso County, CO",2017,2018,233,6602000,200,5690000,33,912000
281,1718,"Erie County, NY",2017,2018,37,1202000,44,1908000,-7,-706000
282,1718,"Fairfax County, VA",2017,2018,81,3960000,26,1008000,55,2952000
283,1718,"Franklin County, OH",2017,2018,169,7021000,143,5021000,26,2000000
284,1718,"Franklin County, WA",2017,2018,67,1228000,75,1637000,-8,-409000
285,1718,"Fresno County, CA",2017,2018,85,2851000,46,1574000,39,1277000
286,1718,"Fulton County, GA",2017,2018,162,8830000,106,4392000,56,4438000
287,1718,"Gallatin County, MT",2017,2018,62,1937000,47,1369000,15,568000
288,1718,"Hamilton County, OH",2017,2018,56,3133000,36,2838000,20,295000
289,1718,"Harris County, TX",2017,2018,378,17638000,274,9536000,104,8102000
290,1718,"Hawaii County, HI",2017,2018,158,4079000,157,4881000,1,-802000
291,1718,"Hennepin County, MN",2017,2018,268,13829000,231,9360000,37,4469000
292,1718,"Hillsborough County, FL",2017,2018,96,3719000,135,4138000,-39,-419000
293,1718,"Honolulu County, HI",2017,2018,833,26230000,404,9900000,429,16330000
294,1718,"Humboldt County, CA",2017,2018,71,1847000,35,1124000,36,723000
295,1718,"Kent County, MI",2017,2018,52,1883000,45,1945000,7,-62000
296,1718,"Kern County, CA",2017,2018,65,1804000,30,636000,35,1168000
297,1718,"King County, WA",2017,2018,3759,198792000,3233,170422000,526,28370000
298,1718,"Kings County, NY",2017,2018,420,35555000,239,15158000,181,20397000
299,1718,"Kitsap County, WA",2017,2018,244,8119000,253,13027000,-9,-4908000
300,1718,"Klickitat County, WA",2017,2018,278,8127000,420,14762000,-142,-6635000
301,1718,"Kootenai County, ID",2017,2018,73,1638000,112,4053000,-39,-2415000
302,1718,"Larimer County, CO",2017,2018,132,5443000,73,3500000,59,1943000
303,1718,"Lewis County, WA",2017,2018,25,821000,45,1408000,-20,-587000
304,1718,"Los Angeles County, CA",2017,2018,3995,160078000,1935,73225000,2060,86853000
305,1718,"Maricopa County, AZ",2017,2018,2518,95394000,3334,164046000,-816,-68652000
306,1718,"Marin County, CA",2017,2018,105,6840000,29,1226000,76,5614000
307,1718,"Maui County, HI",2017,2018,124,3453000,117,4299000,7,-846000
308,1718,"Mecklenburg County, NC",2017,2018,149,8155000,110,5421000,39,2734000
309,1718,"Miami, Dade County",2017,2018,69,2061000,57,2383000,12,-322000
310,1718,"Middlesex County, MA",2017,2018,211,15948000,163,9299000,48,6649000
311,1718,"Milwaukee County, WI",2017,2018,94,3164000,42,1282000,52,1882000
312,1718,"Missoula County, MT",2017,2018,66,1345000,52,1749000,14,-404000
313,1718,"Monterey County, CA",2017,2018,58,1626000,28,983000,30,643000
314,1718,"New York County, NY",2017,2018,260,23925000,201,16323000,59,7602000
315,1718,"Oakland County, MI",2017,2018,123,5715000,80,3003000,43,2712000
316,1718,"Orange County, CA",2017,2018,1758,91104000,774,30550000,984,60554000
317,1718,"Orange County, FL",2017,2018,61,1687000,45,1750000,16,-63000
318,1718,"Orleans Parish, LA",2017,2018,61,2089000,38,1312000,23,777000
319,1718,"Pacific County, WA",2017,2018,74,1987000,147,3571000,-73,-1584000
320,1718,"Palm Beach County, FL",2017,2018,80,3306000,72,2257000,8,1049000
321,1718,"Payette County, ID",2017,2018,329,4514000,334,8179000,-5,-3665000
322,1718,"Philadelphia County, PA",2017,2018,113,4890000,72,3211000,41,1679000
323,1718,"Pierce County, WA",2017,2018,1039,34367000,1056,39435000,-17,-5068000
324,1718,"Pima County, AZ",2017,2018,461,15031000,634,28394000,-173,-13363000
325,1718,"Pinal County, AZ",2017,2018,49,1333000,85,2974000,-36,-1641000
326,1718,"Pinellas County, FL",2017,2018,44,1992000,77,2405000,-33,-413000
327,1718,"Placer County, CA",2017,2018,42,1940000,44,2502000,-2,-562000
328,1718,"Queens County, NY",2017,2018,124,6456000,86,3413000,38,3043000
329,1718,"Ramsey County, MN",2017,2018,54,2032000,40,1159000,14,873000
330,1718,"Riverside County, CA",2017,2018,1109,34115000,791,30611000,318,3504000
331,1718,"Sacramento County, CA",2017,2018,853,27850000,593,18045000,260,9805000
332,1718,"Salt Lake County, UT",2017,2018,621,22924000,520,19425000,101,3499000
333,1718,"San Bernardino County, CA",2017,2018,573,15937000,307,7411000,266,8526000
334,1718,"San Diego County, CA",2017,2018,2355,93406000,1347,55990000,1008,37416000
335,1718,"San Francisco County, CA",2017,2018,700,64681000,342,27063000,358,37618000
336,1718,"San Joaquin County, CA",2017,2018,51,1272000,45,903000,6,369000
337,1718,"San Luis Obispo County, CA",2017,2018,175,7065000,116,3647000,59,3418000
338,1718,"San Mateo County, CA",2017,2018,424,29541000,174,13789000,250,15752000
339,1718,"Santa Barbara County, CA",2017,2018,119,5839000,49,7157000,70,-1318000
340,1718,"Santa Clara County, CA",2017,2018,1895,145084000,978,63128000,917,81956000
341,1718,"Santa Cruz County, CA",2017,2018,102,4508000,51,2448000,51,2060000
342,1718,"Santa Fe County, NM",2017,2018,46,2142000,60,3089000,-14,-947000
343,1718,"Shasta County, CA",2017,2018,242,6274000,176,4223000,66,2051000
344,1718,"Siskiyou County, CA",2017,2018,273,5193000,185,3564000,88,1629000
345,1718,"Skamania County, WA",2017,2018,35,1076000,61,3815000,-26,-2739000
346,1718,"Snohomish County, WA",2017,2018,667,24312000,634,21922000,33,2390000
347,1718,"Sonoma County, CA",2017,2018,580,22139000,215,8519000,365,13620000
348,1718,"Spokane County, WA",2017,2018,516,15833000,921,28975000,-405,-13142000
349,1718,"Suffolk County, MA",2017,2018,99,7660000,65,3147000,34,4513000
350,1718,"Tarrant County, TX",2017,2018,165,5813000,131,4800000,34,1013000
351,1718,"Thurston County, WA",2017,2018,460,15551000,468,14099000,-8,1452000
352,1718,"Travis County, TX",2017,2018,513,24877000,546,25694000,-33,-817000
353,1718,"Utah County, UT",2017,2018,178,4447000,169,5434000,9,-987000
354,1718,"Ventura County, CA",2017,2018,249,8210000,168,6945000,81,1265000
355,1718,"Wake County, NC",2017,2018,116,5259000,76,3788000,40,1471000
356,1718,"Walla Walla County, WA",2017,2018,326,5806000,347,8525000,-21,-2719000
357,1718,"Washoe County, NV",2017,2018,453,17159000,387,13263000,66,3896000
358,1718,"Washtenaw County, MI",2017,2018,82,3632000,44,2630000,38,1002000
359,1718,"Wayne County, MI",2017,2018,40,1670000,42,1485000,-2,185000
360,1718,"Whatcom County, WA",2017,2018,100,3564000,103,4383000,-3,-819000
361,1718,"Williamson County, TX",2017,2018,49,1508000,91,4143000,-42,-2635000
362,1718,"Yakima County, WA",2017,2018,106,1897000,95,2249000,11,-352000
363,1718,"Yavapai County, AZ",2017,2018,28,829000,26,653000,2,176000
364,1819,"Ada County, ID",2018,2019,852,25949000,1179,48982000,-327,-23033000
365,1819,"Alameda County, CA",2018,2019,1474,102440000,550,30369000,924,72071000
366,1819,"Allegheny County, PA",2018,2019,114,5445000,123,6676000,-9,-1231000
367,1819,"Anchorage Municipality, AK",2018,2019,179,7316000,106,4144000,73,3172000
368,1819,"Arapahoe County, CO",2018,2019,122,4736000,140,5549000,-18,-813000
369,1819,"Baltimore city, MD",2018,2019,51,4721000,26,1252000,25,3469000
370,1819,"Bernalillo County, NM",2018,2019,156,6794000,146,6849000,10,-55000
371,1819,"Bexar County, TX",2018,2019,185,10348000,131,5339000,54,5009000
372,1819,"Boulder County, CO",2018,2019,112,5290000,126,7080000,-14,-1790000
373,1819,"Broward County, FL",2018,2019,91,4582000,47,2913000,44,1669000
374,1819,"Buncombe County, NC",2018,2019,26,712000,45,1808000,-19,-1096000
375,1819,"Canyon County, ID",2018,2019,321,4289000,314,6759000,7,-2470000
376,1819,"Chittenden County, VT",2018,2019,46,2674000,35,1395000,11,1279000
377,1819,"Clark County, NV",2018,2019,1279,41143000,1262,80150000,17,-39007000
378,1819,"Clark County, WA",2018,2019,6435,232675000,9530,415895000,-3095,-183220000
379,1819,"Collin County, TX",2018,2019,69,4106000,134,5245000,-65,-1139000
380,1819,"Contra Costa County, CA",2018,2019,567,29828000,206,7437000,361,22391000
381,1819,"Cook County, IL",2018,2019,672,39861000,373,17856000,299,22005000
382,1819,"Cowlitz County, WA",2018,2019,597,15319000,1009,27274000,-412,-11955000
383,1819,"Cumberland County, ME",2018,2019,30,1439000,36,1535000,-6,-96000
384,1819,"Cuyahoga County, OH",2018,2019,62,2555000,43,1581000,19,974000
385,1819,"Dallas County, TX",2018,2019,227,12537000,168,10032000,59,2505000
386,1819,"Dane County, WI",2018,2019,92,4183000,51,2501000,41,1682000
387,1819,"Davidson County, TN",2018,2019,73,3424000,66,3239000,7,185000
388,1819,"DeKalb County, GA",2018,2019,45,2243000,37,1135000,8,1108000
389,1819,"Del Norte County, CA",2018,2019,74,1844000,56,1726000,18,118000
390,1819,"Denver County, CO",2018,2019,326,35552000,318,18605000,8,16947000
391,1819,"District of Columbia, DC",2018,2019,132,8655000,64,3554000,68,5101000
392,1819,"Durham County, NC",2018,2019,53,2408000,36,3192000,17,-784000
393,1819,"Duval County, FL",2018,2019,34,1684000,46,2136000,-12,-452000
394,1819,"El Paso County, CO",2018,2019,132,4334000,100,3380000,32,954000
395,1819,"Fairfax County, VA",2018,2019,43,2087000,68,3275000,-25,-1188000
396,1819,"Flathead County, MT",2018,2019,28,537000,51,2080000,-23,-1543000
397,1819,"Franklin County, OH",2018,2019,152,8191000,112,2574000,40,5617000
398,1819,"Franklin County, WA",2018,2019,75,1191000,114,2432000,-39,-1241000
399,1819,"Fresno County, CA",2018,2019,120,4042000,110,2991000,10,1051000
400,1819,"Fulton County, GA",2018,2019,75,4070000,82,4094000,-7,-24000
401,1819,"Gallatin County, MT",2018,2019,39,1210000,40,1817000,-1,-607000
402,1819,"Harris County, TX",2018,2019,369,14664000,297,9874000,72,4790000
403,1819,"Hawaii County, HI",2018,2019,144,3754000,126,4543000,18,-789000
404,1819,"Hennepin County, MN",2018,2019,268,16105000,220,16863000,48,-758000
405,1819,"Hillsborough County, FL",2018,2019,97,3200000,109,3401000,-12,-201000
406,1819,"Honolulu County, HI",2018,2019,746,24491000,476,17570000,270,6921000
407,1819,"Humboldt County, CA",2018,2019,99,3297000,61,1384000,38,1913000
408,1819,"Island County, WA",2018,2019,35,774000,39,980000,-4,-206000
409,1819,"Kent County, MI",2018,2019,37,1246000,41,1488000,-4,-242000
410,1819,"King County, WA",2018,2019,3204,186774000,3255,185317000,-51,1457000
411,1819,"Kings County, NY",2018,2019,365,28965000,238,12161000,127,16804000
412,1819,"Kitsap County, WA",2018,2019,138,4970000,155,9297000,-17,-4327000
413,1819,"Klickitat County, WA",2018,2019,304,7259000,398,19274000,-94,-12015000
414,1819,"Kootenai County, ID",2018,2019,72,2251000,121,4234000,-49,-1983000
415,1819,"Larimer County, CO",2018,2019,54,1951000,59,2325000,-5,-374000
416,1819,"Lewis County, WA",2018,2019,35,872000,56,1259000,-21,-387000
417,1819,"Los Angeles County, CA",2018,2019,3889,183229000,2092,84301000,1797,98928000
418,1819,"Maricopa County, AZ",2018,2019,2447,90499000,3252,159738000,-805,-69239000
419,1819,"Marin County, CA",2018,2019,120,13275000,59,6386000,61,6889000
420,1819,"Maui County, HI",2018,2019,75,2641000,62,1682000,13,959000
421,1819,"Mecklenburg County, NC",2018,2019,96,5466000,125,5036000,-29,430000
422,1819,"Miami, Dade County",2018,2019,91,3627000,71,2642000,20,985000
423,1819,"Middlesex County, MA",2018,2019,235,16261000,154,14982000,81,1279000
424,1819,"Milwaukee County, WI",2018,2019,69,4262000,34,1897000,35,2365000
425,1819,"Missoula County, MT",2018,2019,62,1708000,80,3062000,-18,-1354000
426,1819,"Monterey County, CA",2018,2019,62,2292000,43,1122000,19,1170000
427,1819,"Montgomery County, MD",2018,2019,68,6606000,35,1292000,33,5314000
428,1819,"New Haven County, CT",2018,2019,32,1383000,28,1549000,4,-166000
429,1819,"New York County, NY",2018,2019,252,30220000,213,16162000,39,14058000
430,1819,"Norfolk County, MA",2018,2019,38,3526000,26,1251000,12,2275000
431,1819,"Oakland County, MI",2018,2019,57,3430000,45,2231000,12,1199000
432,1819,"Orange County, CA",2018,2019,1608,77324000,803,47447000,805,29877000
433,1819,"Orange County, FL",2018,2019,102,3383000,106,6804000,-4,-3421000
434,1819,"Orleans Parish, LA",2018,2019,55,3363000,33,1264000,22,2099000
435,1819,"Pacific County, WA",2018,2019,86,2562000,123,3552000,-37,-990000
436,1819,"Palm Beach County, FL",2018,2019,57,2263000,44,1451000,13,812000
437,1819,"Payette County, ID",2018,2019,304,5067000,308,5145000,-4,-78000
438,1819,"Philadelphia County, PA",2018,2019,114,6624000,103,4623000,11,2001000
439,1819,"Pierce County, WA",2018,2019,1071,40192000,917,37248000,154,2944000
440,1819,"Pima County, AZ",2018,2019,460,18880000,575,24559000,-115,-5679000
441,1819,"Pinellas County, FL",2018,2019,69,2692000,54,2821000,15,-129000
442,1819,"Placer County, CA",2018,2019,111,3499000,67,4002000,44,-503000
443,1819,"Queens County, NY",2018,2019,92,5065000,50,2239000,42,2826000
444,1819,"Ramsey County, MN",2018,2019,47,1527000,49,1793000,-2,-266000
445,1819,"Riverside County, CA",2018,2019,982,37498000,694,42634000,288,-5136000
446,1819,"Sacramento County, CA",2018,2019,892,35216000,636,21316000,256,13900000
447,1819,"Salt Lake County, UT",2018,2019,564,22137000,445,15483000,119,6654000
448,1819,"San Bernardino County, CA",2018,2019,553,14988000,296,8350000,257,6638000
449,1819,"San Diego County, CA",2018,2019,2142,87702000,1408,59028000,734,28674000
450,1819,"San Francisco County, CA",2018,2019,910,95744000,422,43332000,488,52412000
451,1819,"San Luis Obispo County, CA",2018,2019,57,2146000,36,1446000,21,700000
452,1819,"San Mateo County, CA",2018,2019,387,27711000,162,14346000,225,13365000
453,1819,"Santa Barbara County, CA",2018,2019,95,3465000,51,3910000,44,-445000
454,1819,"Santa Clara County, CA",2018,2019,1661,159345000,928,70743000,733,88602000
455,1819,"Santa Cruz County, CA",2018,2019,161,6035000,89,3658000,72,2377000
456,1819,"Santa Fe County, NM",2018,2019,28,1002000,37,1676000,-9,-674000
457,1819,"Shasta County, CA",2018,2019,121,3201000,50,1157000,71,2044000
458,1819,"Shelby County, TN",2018,2019,35,1136000,42,1993000,-7,-857000
459,1819,"Siskiyou County, CA",2018,2019,219,7609000,107,2082000,112,5527000
460,1819,"Skamania County, WA",2018,2019,31,1357000,81,4411000,-50,-3054000
461,1819,"Snohomish County, WA",2018,2019,710,29498000,707,27800000,3,1698000
462,1819,"Solano County, CA",2018,2019,50,1647000,41,905000,9,742000
463,1819,"Sonoma County, CA",2018,2019,238,10001000,102,3395000,136,6606000
464,1819,"Spokane County, WA",2018,2019,571,18476000,748,24395000,-177,-5919000
465,1819,"Suffolk County, MA",2018,2019,123,8574000,58,4428000,65,4146000
466,1819,"Tarrant County, TX",2018,2019,148,4515000,146,4362000,2,153000
467,1819,"Thurston County, WA",2018,2019,365,12498000,416,14798000,-51,-2300000
468,1819,"Travis County, TX",2018,2019,548,38211000,518,33069000,30,5142000
469,1819,"Utah County, UT",2018,2019,145,4033000,185,6495000,-40,-2462000
470,1819,"Ventura County, CA",2018,2019,336,12134000,172,7014000,164,5120000
471,1819,"Wake County, NC",2018,2019,116,4915000,98,5894000,18,-979000
472,1819,"Walla Walla County, WA",2018,2019,343,7707000,316,9131000,27,-1424000
473,1819,"Washoe County, NV",2018,2019,384,15946000,374,14683000,10,1263000
474,1819,"Washtenaw County, MI",2018,2019,45,2109000,44,1906000,1,203000
475,1819,"Wayne County, MI",2018,2019,52,2529000,34,1442000,18,1087000
476,1819,"Whatcom County, WA",2018,2019,192,6607000,205,8174000,-13,-1567000
477,1819,"Whitman County, WA",2018,2019,25,936000,33,1126000,-8,-190000
478,1819,"Williamson County, TX",2018,2019,27,1071000,42,1318000,-15,-247000
479,1819,"Yakima County, WA",2018,2019,116,2463000,75,2304000,41,159000
480,1920,"Ada County, ID",2019,2020,824,24895000,1489,60829000,-665,-35934000
481,1920,"Adams County, CO",2019,2020,29,1250000,43,2417000,-14,-1167000
482,1920,"Alameda County, CA",2019,2020,1539,114915000,472,27527000,1067,87388000
483,1920,"Allegheny County, PA",2019,2020,131,5217000,112,7005000,19,-1788000
484,1920,"Anchorage Municipality, AK",2019,2020,187,7368000,138,5068000,49,2300000
485,1920,"Arapahoe County, CO",2019,2020,130,4781000,144,6035000,-14,-1254000
486,1920,"Baltimore city, MD",2019,2020,58,2725000,30,1026000,28,1699000
487,1920,"Bernalillo County, NM",2019,2020,193,7688000,191,7843000,2,-155000
488,1920,"Bexar County, TX",2019,2020,182,7285000,197,8794000,-15,-1509000
489,1920,"Boulder County, CO",2019,2020,61,3113000,75,4052000,-14,-939000
490,1920,"Broward County, FL",2019,2020,58,2416000,32,1688000,26,728000
491,1920,"Buncombe County, NC",2019,2020,29,1586000,31,1270000,-2,316000
492,1920,"Butte County, CA",2019,2020,74,1975000,26,712000,48,1263000
493,1920,"Canyon County, ID",2019,2020,330,6110000,380,7965000,-50,-1855000
494,1920,"Clark County, NV",2019,2020,1445,49551000,1439,58447000,6,-8896000
495,1920,"Clark County, WA",2019,2020,6633,259380000,10751,467025000,-4118,-207645000
496,1920,"Coconino County, AZ",2019,2020,42,1439000,31,1529000,11,-90000
497,1920,"Collin County, TX",2019,2020,140,5500000,214,9296000,-74,-3796000
498,1920,"Contra Costa County, CA",2019,2020,773,43368000,333,15553000,440,27815000
499,1920,"Cook County, IL",2019,2020,599,38525000,441,20646000,158,17879000
500,1920,"Cowlitz County, WA",2019,2020,653,16491000,948,33885000,-295,-17394000
501,1920,"Cumberland County, ME",2019,2020,35,2537000,55,3603000,-20,-1066000
502,1920,"Cuyahoga County, OH",2019,2020,65,3612000,52,2205000,13,1407000
503,1920,"Dallas County, TX",2019,2020,211,12770000,232,11884000,-21,886000
504,1920,"Dane County, WI",2019,2020,76,3925000,48,2225000,28,1700000
505,1920,"Davidson County, TN",2019,2020,107,5431000,96,5477000,11,-46000
506,1920,"DeKalb County, GA",2019,2020,51,1828000,44,1271000,7,557000
507,1920,"Del Norte County, CA",2019,2020,92,2637000,87,1834000,5,803000
508,1920,"Denton County, TX",2019,2020,76,2949000,94,5431000,-18,-2482000
509,1920,"Denver County, CO",2019,2020,294,13828000,274,13790000,20,38000
510,1920,"District of Columbia, DC",2019,2020,182,13881000,69,3424000,113,10457000
511,1920,"DuPage County, IL",2019,2020,44,2007000,27,1409000,17,598000
512,1920,"Duval County, FL",2019,2020,38,1215000,34,1175000,4,40000
513,1920,"El Paso County, CO",2019,2020,177,4962000,181,7125000,-4,-2163000
514,1920,"Erie County, NY",2019,2020,31,1340000,29,1573000,2,-233000
515,1920,"Fairfax County, VA",2019,2020,72,3254000,75,3293000,-3,-39000
516,1920,"Flathead County, MT",2019,2020,38,760000,49,2847000,-11,-2087000
517,1920,"Franklin County, OH",2019,2020,138,6281000,163,4715000,-25,1566000
518,1920,"Franklin County, WA",2019,2020,72,1281000,90,2061000,-18,-780000
519,1920,"Fresno County, CA",2019,2020,103,2797000,45,1220000,58,1577000
520,1920,"Fulton County, GA",2019,2020,79,5288000,55,4561000,24,727000
521,1920,"Gallatin County, MT",2019,2020,53,1527000,45,2358000,8,-831000
522,1920,"Hamilton County, OH",2019,2020,42,1851000,34,1501000,8,350000
523,1920,"Harris County, TX",2019,2020,444,23346000,405,15032000,39,8314000
524,1920,"Hawaii County, HI",2019,2020,186,5116000,208,6861000,-22,-1745000
525,1920,"Hennepin County, MN",2019,2020,251,14651000,197,9518000,54,5133000
526,1920,"Hillsborough County, FL",2019,2020,141,4244000,129,4660000,12,-416000
527,1920,"Honolulu County, HI",2019,2020,727,24060000,465,16142000,262,7918000
528,1920,"Humboldt County, CA",2019,2020,133,3711000,84,2579000,49,1132000
529,1920,"Kent County, MI",2019,2020,34,1252000,40,1625000,-6,-373000
530,1920,"Kern County, CA",2019,2020,106,2441000,75,1892000,31,549000
531,1920,"King County, WA",2019,2020,3513,224709000,2824,178159000,689,46550000
532,1920,"Kings County, NY",2019,2020,474,34302000,173,8007000,301,26295000
533,1920,"Kitsap County, WA",2019,2020,210,7454000,267,11606000,-57,-4152000
534,1920,"Klickitat County, WA",2019,2020,250,8165000,441,21229000,-191,-13064000
535,1920,"Larimer County, CO",2019,2020,110,3895000,100,4803000,10,-908000
536,1920,"Lee County, FL",2019,2020,22,1058000,43,933000,-21,125000
537,1920,"Lewis County, WA",2019,2020,35,1342000,44,1601000,-9,-259000
538,1920,"Los Angeles County, CA",2019,2020,4415,237518000,1771,74517000,2644,163001000
539,1920,"Maricopa County, AZ",2019,2020,2625,98130000,3721,189353000,-1096,-91223000
540,1920,"Marin County, CA",2019,2020,150,12225000,44,4751000,106,7474000
541,1920,"Maui County, HI",2019,2020,142,4720000,135,4752000,7,-32000
542,1920,"Mecklenburg County, NC",2019,2020,93,4142000,109,4428000,-16,-286000
543,1920,"Miami, Dade County",2019,2020,86,4486000,77,3813000,9,673000
544,1920,"Middlesex County, MA",2019,2020,201,13930000,126,7619000,75,6311000
545,1920,"Milwaukee County, WI",2019,2020,64,2713000,62,1975000,2,738000
546,1920,"Missoula County, MT",2019,2020,54,1681000,66,2724000,-12,-1043000
547,1920,"Mohave County, AZ",2019,2020,32,627000,40,1092000,-8,-465000
548,1920,"Monroe County, NY",2019,2020,37,1224000,43,2008000,-6,-784000
549,1920,"Monterey County, CA",2019,2020,47,1482000,35,1308000,12,174000
550,1920,"Montgomery County, MD",2019,2020,50,2794000,35,2536000,15,258000
551,1920,"Nevada County, CA",2019,2020,53,943000,36,1945000,17,-1002000
552,1920,"New York County, NY",2019,2020,269,24711000,150,9571000,119,15140000
553,1920,"Oakland County, MI",2019,2020,139,5640000,89,4810000,50,830000
554,1920,"Oklahoma County, OK",2019,2020,49,2337000,48,1649000,1,688000
555,1920,"Orange County, CA",2019,2020,1678,76262000,892,46393000,786,29869000
556,1920,"Orange County, FL",2019,2020,109,3782000,106,4130000,3,-348000
557,1920,"Orleans Parish, LA",2019,2020,61,2212000,46,1681000,15,531000
558,1920,"Pacific County, WA",2019,2020,79,1764000,104,3196000,-25,-1432000
559,1920,"Palm Beach County, FL",2019,2020,47,1522000,37,1749000,10,-227000
560,1920,"Payette County, ID",2019,2020,288,4378000,282,5740000,6,-1362000
561,1920,"Philadelphia County, PA",2019,2020,121,7148000,95,7140000,26,8000
562,1920,"Pierce County, WA",2019,2020,1045,41478000,1054,33198000,-9,8280000
563,1920,"Pima County, AZ",2019,2020,490,16964000,710,32691000,-220,-15727000
564,1920,"Pinal County, AZ",2019,2020,39,952000,147,6225000,-108,-5273000
565,1920,"Pinellas County, FL",2019,2020,89,4102000,86,4263000,3,-161000
566,1920,"Placer County, CA",2019,2020,100,4046000,102,3844000,-2,202000
567,1920,"Queens County, NY",2019,2020,119,5947000,44,1880000,75,4067000
568,1920,"Ramsey County, MN",2019,2020,39,2027000,42,1867000,-3,160000
569,1920,"Riverside County, CA",2019,2020,1038,41725000,870,43174000,168,-1449000
570,1920,"Sacramento County, CA",2019,2020,890,34017000,688,24386000,202,9631000
571,1920,"Salt Lake County, UT",2019,2020,700,26296000,562,22596000,138,3700000
572,1920,"San Bernardino County, CA",2019,2020,683,17038000,370,8780000,313,8258000
573,1920,"San Diego County, CA",2019,2020,2170,117246000,1395,62880000,775,54366000
574,1920,"San Francisco County, CA",2019,2020,1104,127657000,304,23990000,800,103667000
575,1920,"San Joaquin County, CA",2019,2020,148,4019000,77,2365000,71,1654000
576,1920,"San Luis Obispo County, CA",2019,2020,66,2310000,54,1843000,12,467000
577,1920,"San Mateo County, CA",2019,2020,391,32141000,149,9747000,242,22394000
578,1920,"Santa Barbara County, CA",2019,2020,87,3816000,67,3188000,20,628000
579,1920,"Santa Clara County, CA",2019,2020,1845,162721000,705,64168000,1140,98553000
580,1920,"Santa Cruz County, CA",2019,2020,110,6006000,65,3050000,45,2956000
581,1920,"Santa Fe County, NM",2019,2020,32,1243000,58,2567000,-26,-1324000
582,1920,"Shasta County, CA",2019,2020,148,4651000,96,2201000,52,2450000
583,1920,"Shelby County, TN",2019,2020,47,1866000,36,1145000,11,721000
584,1920,"Siskiyou County, CA",2019,2020,166,4011000,111,2562000,55,1449000
585,1920,"Snohomish County, WA",2019,2020,760,31931000,652,29050000,108,2881000
586,1920,"Solano County, CA",2019,2020,39,1531000,46,1900000,-7,-369000
587,1920,"Sonoma County, CA",2019,2020,385,18408000,174,6737000,211,11671000
588,1920,"Spokane County, WA",2019,2020,527,17649000,894,29826000,-367,-12177000
589,1920,"St. Louis County, MO",2019,2020,56,2427000,36,1299000,20,1128000
590,1920,"St. Louis city, MO",2019,2020,41,1984000,27,1236000,14,748000
591,1920,"Suffolk County, MA",2019,2020,120,9196000,73,5885000,47,3311000
592,1920,"Tarrant County, TX",2019,2020,175,6535000,207,11012000,-32,-4477000
593,1920,"Thurston County, WA",2019,2020,393,12557000,420,17030000,-27,-4473000
594,1920,"Travis County, TX",2019,2020,412,27782000,514,44344000,-102,-16562000
595,1920,"Utah County, UT",2019,2020,283,6233000,386,11439000,-103,-5206000
596,1920,"Ventura County, CA",2019,2020,263,10983000,149,6039000,114,4944000
597,1920,"Wake County, NC",2019,2020,100,3724000,104,5467000,-4,-1743000
598,1920,"Walla Walla County, WA",2019,2020,322,7990000,365,9708000,-43,-1718000
599,1920,"Washoe County, NV",2019,2020,498,18079000,421,16597000,77,1482000
600,1920,"Washtenaw County, MI",2019,2020,61,3802000,27,1186000,34,2616000
601,1920,"Wayne County, MI",2019,2020,24,1313000,47,1511000,-23,-198000
602,1920,"Whatcom County, WA",2019,2020,185,6112000,251,11339000,-66,-5227000
603,1920,"Williamson County, TX",2019,2020,66,1574000,103,7393000,-37,-5819000
604,1920,"Yakima County, WA",2019,2020,152,3551000,111,3106000,41,445000
605,2021,"Ada County, ID",2020,2021,1052,37810000,1742,77989000,-690,-40179000
606,2021,"Alameda County, CA",2020,2021,1523,135159000,494,32819000,1029,102340000
607,2021,"Allegheny County, PA",2020,2021,67,4723000,96,6710000,-29,-1987000
608,2021,"Anchorage Municipality, AK",2020,2021,144,6513000,150,6728000,-6,-215000
609,2021,"Arapahoe County, CO",2020,2021,130,4195000,124,6009000,6,-1814000
610,2021,"Baltimore city, MD",2020,2021,45,2732000,51,3361000,-6,-629000
611,2021,"Bernalillo County, NM",2020,2021,158,7517000,162,7399000,-4,118000
612,2021,"Bexar County, TX",2020,2021,169,6406000,366,14492000,-197,-8086000
613,2021,"Boulder County, CO",2020,2021,127,6032000,159,7714000,-32,-1682000
614,2021,"Broward County, FL",2020,2021,88,6192000,100,5273000,-12,919000
615,2021,"Buncombe County, NC",2020,2021,22,560000,61,3205000,-39,-2645000
616,2021,"Canyon County, ID",2020,2021,400,7931000,577,18058000,-177,-10127000
617,2021,"Chittenden County, VT",2020,2021,22,1106000,48,2197000,-26,-1091000
618,2021,"Clark County, NV",2020,2021,1310,43757000,1510,79092000,-200,-35335000
619,2021,"Clark County, WA",2020,2021,5942,215827000,11127,613103000,-5185,-397276000
620,2021,"Coconino County, AZ",2020,2021,36,867000,28,1061000,8,-194000
621,2021,"Collin County, TX",2020,2021,96,5109000,327,16805000,-231,-11696000
622,2021,"Contra Costa County, CA",2020,2021,646,39262000,212,10598000,434,28664000
623,2021,"Cook County, IL",2020,2021,570,35099000,344,21656000,226,13443000
624,2021,"Cowlitz County, WA",2020,2021,578,15451000,961,36440000,-383,-20989000
625,2021,"Cumberland County, ME",2020,2021,31,1581000,50,2986000,-19,-1405000
626,2021,"Cuyahoga County, OH",2020,2021,60,2908000,50,2002000,10,906000
627,2021,"Dallas County, TX",2020,2021,250,11495000,324,18520000,-74,-7025000
628,2021,"Dane County, WI",2020,2021,80,3950000,60,2230000,20,1720000
629,2021,"Davidson County, TN",2020,2021,107,6805000,122,5659000,-15,1146000
630,2021,"DeKalb County, GA",2020,2021,82,3212000,40,2615000,42,597000
631,2021,"Del Norte County, CA",2020,2021,98,4576000,97,2869000,1,1707000
632,2021,"Denton County, TX",2020,2021,95,3721000,200,10990000,-105,-7269000
633,2021,"Denver County, CO",2020,2021,444,25234000,415,20996000,29,4238000
634,2021,"District of Columbia, DC",2020,2021,119,9107000,108,6966000,11,2141000
635,2021,"DuPage County, IL",2020,2021,32,1562000,27,1105000,5,457000
636,2021,"Durham County, NC",2020,2021,42,2243000,40,1896000,2,347000
637,2021,"Duval County, FL",2020,2021,37,1315000,104,3082000,-67,-1767000
638,2021,"El Dorado County, CA",2020,2021,34,1687000,31,1836000,3,-149000
639,2021,"El Paso County, CO",2020,2021,217,6535000,232,7574000,-15,-1039000
640,2021,"Fairfax County, VA",2020,2021,90,5192000,75,3835000,15,1357000
641,2021,"Fairfield County, CT",2020,2021,35,1651000,46,3454000,-11,-1803000
642,2021,"Franklin County, OH",2020,2021,124,5846000,140,5730000,-16,116000
643,2021,"Franklin County, WA",2020,2021,112,2030000,61,1409000,51,621000
644,2021,"Fresno County, CA",2020,2021,102,5005000,47,1395000,55,3610000
645,2021,"Fulton County, GA",2020,2021,108,6949000,120,6547000,-12,402000
646,2021,"Gallatin County, MT",2020,2021,46,1590000,78,3119000,-32,-1529000
647,2021,"Hamilton County, OH",2020,2021,35,1860000,29,1265000,6,595000
648,2021,"Harris County, TX",2020,2021,398,21126000,470,23214000,-72,-2088000
649,2021,"Hawaii County, HI",2020,2021,119,4214000,222,7728000,-103,-3514000
650,2021,"Hennepin County, MN",2020,2021,279,16417000,226,11832000,53,4585000
651,2021,"Hillsborough County, FL",2020,2021,96,3942000,179,7353000,-83,-3411000
652,2021,"Honolulu County, HI",2020,2021,622,19104000,397,20585000,225,-1481000
653,2021,"Humboldt County, CA",2020,2021,127,4157000,70,1976000,57,2181000
654,2021,"Johnson County, KS",2020,2021,29,1486000,34,1402000,-5,84000
655,2021,"Kent County, MI",2020,2021,33,1520000,40,1818000,-7,-298000
656,2021,"Kern County, CA",2020,2021,68,2300000,36,813000,32,1487000
657,2021,"King County, WA",2020,2021,3543,274124000,3018,214060000,525,60064000
658,2021,"Kings County, NY",2020,2021,459,31419000,218,14024000,241,17395000
659,2021,"Kitsap County, WA",2020,2021,122,5187000,198,15388000,-76,-10201000
660,2021,"Klickitat County, WA",2020,2021,248,7819000,405,22089000,-157,-14270000
661,2021,"Kootenai County, ID",2020,2021,35,931000,72,2856000,-37,-1925000
662,2021,"Larimer County, CO",2020,2021,136,4955000,92,3920000,44,1035000
663,2021,"Los Angeles County, CA",2020,2021,4450,227558000,2010,99900000,2440,127658000
664,2021,"Maricopa County, AZ",2020,2021,2901,118987000,4243,233945000,-1342,-114958000
665,2021,"Marin County, CA",2020,2021,119,9183000,34,1968000,85,7215000
666,2021,"Maui County, HI",2020,2021,106,3816000,96,4036000,10,-220000
667,2021,"Mecklenburg County, NC",2020,2021,59,2810000,71,4867000,-12,-2057000
668,2021,"Miami, Dade County",2020,2021,109,4378000,124,5857000,-15,-1479000
669,2021,"Middlesex County, MA",2020,2021,196,16705000,180,10239000,16,6466000
670,2021,"Milwaukee County, WI",2020,2021,68,5371000,69,2505000,-1,2866000
671,2021,"Missoula County, MT",2020,2021,65,1815000,86,3819000,-21,-2004000
672,2021,"Monroe County, NY",2020,2021,47,2276000,41,1714000,6,562000
673,2021,"Monterey County, CA",2020,2021,82,3765000,24,1046000,58,2719000
674,2021,"Montgomery County, MD",2020,2021,50,4270000,44,2557000,6,1713000
675,2021,"Nevada County, CA",2020,2021,28,956000,35,1558000,-7,-602000
676,2021,"New York County, NY",2020,2021,236,21441000,225,19429000,11,2012000
677,2021,"Norfolk County, MA",2020,2021,44,2753000,34,1971000,10,782000
678,2021,"Oakland County, MI",2020,2021,55,3701000,69,4492000,-14,-791000
679,2021,"Oklahoma County, OK",2020,2021,30,1285000,42,1044000,-12,241000
680,2021,"Orange County, CA",2020,2021,1586,73419000,859,46526000,727,26893000
681,2021,"Orange County, FL",2020,2021,102,3514000,145,6330000,-43,-2816000
682,2021,"Orleans Parish, LA",2020,2021,68,2237000,37,2014000,31,223000
683,2021,"Pacific County, WA",2020,2021,73,1567000,94,3744000,-21,-2177000
684,2021,"Palm Beach County, FL",2020,2021,41,1355000,76,3899000,-35,-2544000
685,2021,"Payette County, ID",2020,2021,241,4381000,254,8591000,-13,-4210000
686,2021,"Philadelphia County, PA",2020,2021,95,5680000,86,4368000,9,1312000
687,2021,"Pierce County, WA",2020,2021,1028,42628000,1006,43067000,22,-439000
688,2021,"Pima County, AZ",2020,2021,517,17087000,762,37860000,-245,-20773000
689,2021,"Pinal County, AZ",2020,2021,67,1956000,257,9565000,-190,-7609000
690,2021,"Pinellas County, FL",2020,2021,62,3113000,65,3430000,-3,-317000
691,2021,"Placer County, CA",2020,2021,109,4724000,110,4129000,-1,595000
692,2021,"Queens County, NY",2020,2021,67,4125000,48,2755000,19,1370000
693,2021,"Ramsey County, MN",2020,2021,56,2396000,46,1236000,10,1160000
694,2021,"Riverside County, CA",2020,2021,1085,41870000,771,52216000,314,-10346000
695,2021,"Sacramento County, CA",2020,2021,854,35033000,540,20461000,314,14572000
696,2021,"Salt Lake County, UT",2020,2021,695,28413000,691,25382000,4,3031000
697,2021,"San Bernardino County, CA",2020,2021,584,19431000,328,9996000,256,9435000
698,2021,"San Diego County, CA",2020,2021,2307,108185000,1496,66971000,811,41214000
699,2021,"San Francisco County, CA",2020,2021,887,124074000,360,32378000,527,91696000
700,2021,"San Joaquin County, CA",2020,2021,122,5374000,61,2302000,61,3072000
701,2021,"San Luis Obispo County, CA",2020,2021,96,4397000,106,5911000,-10,-1514000
702,2021,"San Mateo County, CA",2020,2021,367,42738000,124,9512000,243,33226000
703,2021,"Santa Barbara County, CA",2020,2021,97,4747000,71,4340000,26,407000
704,2021,"Santa Clara County, CA",2020,2021,1571,167118000,675,54339000,896,112779000
705,2021,"Santa Cruz County, CA",2020,2021,94,4855000,48,2437000,46,2418000
706,2021,"Santa Fe County, NM",2020,2021,22,827000,42,2353000,-20,-1526000
707,2021,"Shasta County, CA",2020,2021,177,6106000,105,3314000,72,2792000
708,2021,"Siskiyou County, CA",2020,2021,235,6511000,133,3152000,102,3359000
709,2021,"Skamania County, WA",2020,2021,27,1543000,104,5476000,-77,-3933000
710,2021,"Snohomish County, WA",2020,2021,613,24522000,642,30675000,-29,-6153000
711,2021,"Solano County, CA",2020,2021,101,3738000,74,2675000,27,1063000
712,2021,"Sonoma County, CA",2020,2021,486,22740000,204,9953000,282,12787000
713,2021,"Spokane County, WA",2020,2021,634,22471000,789,33753000,-155,-11282000
714,2021,"St. Louis County, MO",2020,2021,40,2123000,45,2249000,-5,-126000
715,2021,"St. Louis city, MO",2020,2021,40,2774000,25,1031000,15,1743000
716,2021,"Stanislaus County, CA",2020,2021,43,1487000,33,913000,10,574000
717,2021,"Suffolk County, MA",2020,2021,71,5734000,89,4842000,-18,892000
718,2021,"Tarrant County, TX",2020,2021,150,5205000,207,7926000,-57,-2721000
719,2021,"Thurston County, WA",2020,2021,441,16354000,442,16583000,-1,-229000
720,2021,"Travis County, TX",2020,2021,502,32013000,620,49537000,-118,-17524000
721,2021,"Utah County, UT",2020,2021,200,6371000,305,9743000,-105,-3372000
722,2021,"Ventura County, CA",2020,2021,197,7901000,146,6301000,51,1600000
723,2021,"Wake County, NC",2020,2021,85,3002000,133,5953000,-48,-2951000
724,2021,"Walla Walla County, WA",2020,2021,325,6873000,410,11577000,-85,-4704000
725,2021,"Washoe County, NV",2020,2021,386,15095000,372,19271000,14,-4176000
726,2021,"Washtenaw County, MI",2020,2021,41,1591000,52,3591000,-11,-2000000
727,2021,"Wayne County, MI",2020,2021,36,1609000,41,1362000,-5,247000
728,2021,"Whatcom County, WA",2020,2021,147,4667000,213,11180000,-66,-6513000
729,2021,"Williamson County, TX",2020,2021,94,4329000,244,15125000,-150,-10796000
730,2021,"Yakima County, WA",2020,2021,133,3332000,153,3632000,-20,-300000
731,2021,"Yavapai County, AZ",2020,2021,28,1189000,64,3683000,-36,-2494000
732,2021,"Yellowstone County, MT",2020,2021,26,839000,26,788000,0,51000
733,2021,"Yolo County, CA",2020,2021,32,1090000,29,1520000,3,-430000
