,unique_tag,secondary_county_y,yr_range,year1,year2,n2_inflow,agi_inflow,n2_outflow,agi_outflow,n2_net,agi_net,arc_county,unique_tag2
1,Baker County-Union County-OR-1718,"Union County, OR",1718,2017,2018,88,1898000,95,1404000,-7,494000,Baker County,Baker County-Union County-OR
3,Benton County-Linn County-OR-1718,"Linn County, OR",1718,2017,2018,989,24061000,1380,42582000,-391,-18521000,Benton County,Benton County-Linn County-OR
4,Benton County-Lane County-OR-1718,"Lane County, OR",1718,2017,2018,392,9846000,353,9958000,39,-112000,Benton County,Benton County-Lane County-OR
5,Benton County-Multnomah County-OR-1718,"Multnomah County, OR",1718,2017,2018,256,7928000,317,10701000,-61,-2773000,Benton County,Benton County-Multnomah County-OR
6,Benton County-Marion County-OR-1718,"Marion County, OR",1718,2017,2018,229,6252000,287,8983000,-58,-2731000,Benton County,Benton County-Marion County-OR
7,Benton County-Washington County-OR-1718,"Washington County, OR",1718,2017,2018,138,3664000,291,6818000,-153,-3154000,Benton County,Benton County-Washington County-OR
8,Benton County-Polk County-OR-1718,"Polk County, OR",1718,2017,2018,212,5128000,181,5354000,31,-226000,Benton County,Benton County-Polk County-OR
9,Benton County-Deschutes County-OR-1718,"Deschutes County, OR",1718,2017,2018,129,4176000,171,9663000,-42,-5487000,Benton County,Benton County-Deschutes County-OR
10,Benton County-Clackamas County-OR-1718,"Clackamas County, OR",1718,2017,2018,113,3137000,170,7245000,-57,-4108000,Benton County,Benton County-Clackamas County-OR
11,Benton County-Lincoln County-OR-1718,"Lincoln County, OR",1718,2017,2018,127,3865000,103,3553000,24,312000,Benton County,Benton County-Lincoln County-OR
12,Benton County-King County-WA-1718,"King County, WA",1718,2017,2018,79,3413000,119,4152000,-40,-739000,Benton County,Benton County-King County-WA
13,Benton County-Los Angeles County-CA-1718,"Los Angeles County, CA",1718,2017,2018,89,3320000,44,576000,45,2744000,Benton County,Benton County-Los Angeles County-CA
14,Benton County-San Diego County-CA-1718,"San Diego County, CA",1718,2017,2018,71,2406000,51,1392000,20,1014000,Benton County,Benton County-San Diego County-CA
15,Benton County-Douglas County-OR-1718,"Douglas County, OR",1718,2017,2018,73,1699000,44,979000,29,720000,Benton County,Benton County-Douglas County-OR
16,Benton County-Jackson County-OR-1718,"Jackson County, OR",1718,2017,2018,81,1468000,53,1928000,28,-460000,Benton County,Benton County-Jackson County-OR
17,Benton County-Yamhill County-OR-1718,"Yamhill County, OR",1718,2017,2018,37,1033000,52,2706000,-15,-1673000,Benton County,Benton County-Yamhill County-OR
18,Benton County-Maricopa County-AZ-1718,"Maricopa County, AZ",1718,2017,2018,49,1690000,74,2354000,-25,-664000,Benton County,Benton County-Maricopa County-AZ
19,Benton County-Clark County-WA-1718,"Clark County, WA",1718,2017,2018,43,1229000,69,4636000,-26,-3407000,Benton County,Benton County-Clark County-WA
20,Benton County-Santa Clara County-CA-1718,"Santa Clara County, CA",1718,2017,2018,38,2768000,63,2879000,-25,-111000,Benton County,Benton County-Santa Clara County-CA
22,Clackamas County-Multnomah County-OR-1718,"Multnomah County, OR",1718,2017,2018,9734,351923000,6351,228376000,3383,123547000,Clackamas County,Clackamas County-Multnomah County-OR
23,Clackamas County-Washington County-OR-1718,"Washington County, OR",1718,2017,2018,3803,168550000,3293,132725000,510,35825000,Clackamas County,Clackamas County-Washington County-OR
24,Clackamas County-Marion County-OR-1718,"Marion County, OR",1718,2017,2018,1233,38326000,1770,48263000,-537,-9937000,Clackamas County,Clackamas County-Marion County-OR
25,Clackamas County-Clark County-WA-1718,"Clark County, WA",1718,2017,2018,1122,39046000,1651,64611000,-529,-25565000,Clackamas County,Clackamas County-Clark County-WA
26,Clackamas County-Los Angeles County-CA-1718,"Los Angeles County, CA",1718,2017,2018,457,21790000,186,6793000,271,14997000,Clackamas County,Clackamas County-Los Angeles County-CA
27,Clackamas County-Lane County-OR-1718,"Lane County, OR",1718,2017,2018,349,14240000,268,9553000,81,4687000,Clackamas County,Clackamas County-Lane County-OR
28,Clackamas County-Yamhill County-OR-1718,"Yamhill County, OR",1718,2017,2018,342,12515000,476,16555000,-134,-4040000,Clackamas County,Clackamas County-Yamhill County-OR
29,Clackamas County-King County-WA-1718,"King County, WA",1718,2017,2018,339,18134000,323,19887000,16,-1753000,Clackamas County,Clackamas County-King County-WA
30,Clackamas County-Deschutes County-OR-1718,"Deschutes County, OR",1718,2017,2018,277,9679000,532,22748000,-255,-13069000,Clackamas County,Clackamas County-Deschutes County-OR
31,Clackamas County-Maricopa County-AZ-1718,"Maricopa County, AZ",1718,2017,2018,253,10220000,455,28931000,-202,-18711000,Clackamas County,Clackamas County-Maricopa County-AZ
32,Clackamas County-Benton County-OR-1718,"Benton County, OR",1718,2017,2018,170,7245000,113,3137000,57,4108000,Clackamas County,Clackamas County-Benton County-OR
33,Clackamas County-San Diego County-CA-1718,"San Diego County, CA",1718,2017,2018,241,11181000,141,6755000,100,4426000,Clackamas County,Clackamas County-San Diego County-CA
34,Clackamas County-Santa Clara County-CA-1718,"Santa Clara County, CA",1718,2017,2018,258,21913000,93,5668000,165,16245000,Clackamas County,Clackamas County-Santa Clara County-CA
35,Clackamas County-Orange County-CA-1718,"Orange County, CA",1718,2017,2018,198,9759000,117,5650000,81,4109000,Clackamas County,Clackamas County-Orange County-CA
36,Clackamas County-Polk County-OR-1718,"Polk County, OR",1718,2017,2018,171,5729000,171,5197000,0,532000,Clackamas County,Clackamas County-Polk County-OR
37,Clackamas County-Alameda County-CA-1718,"Alameda County, CA",1718,2017,2018,176,13236000,58,2127000,118,11109000,Clackamas County,Clackamas County-Alameda County-CA
38,Clackamas County-Jackson County-OR-1718,"Jackson County, OR",1718,2017,2018,145,4764000,116,5848000,29,-1084000,Clackamas County,Clackamas County-Jackson County-OR
39,Clackamas County-Linn County-OR-1718,"Linn County, OR",1718,2017,2018,141,4067000,186,5955000,-45,-1888000,Clackamas County,Clackamas County-Linn County-OR
40,Clackamas County-Columbia County-OR-1718,"Columbia County, OR",1718,2017,2018,135,3327000,170,5916000,-35,-2589000,Clackamas County,Clackamas County-Columbia County-OR
41,Clackamas County-Riverside County-CA-1718,"Riverside County, CA",1718,2017,2018,146,5097000,93,3794000,53,1303000,Clackamas County,Clackamas County-Riverside County-CA
42,Clackamas County-Clark County-NV-1718,"Clark County, NV",1718,2017,2018,133,4346000,177,7534000,-44,-3188000,Clackamas County,Clackamas County-Clark County-NV
43,Clackamas County-Honolulu County-HI-1718,"Honolulu County, HI",1718,2017,2018,123,4694000,59,1375000,64,3319000,Clackamas County,Clackamas County-Honolulu County-HI
44,Clackamas County-Pierce County-WA-1718,"Pierce County, WA",1718,2017,2018,106,4584000,127,4650000,-21,-66000,Clackamas County,Clackamas County-Pierce County-WA
45,Clackamas County-Contra Costa County-CA-1718,"Contra Costa County, CA",1718,2017,2018,117,9816000,51,1763000,66,8053000,Clackamas County,Clackamas County-Contra Costa County-CA
46,Clackamas County-Clatsop County-OR-1718,"Clatsop County, OR",1718,2017,2018,80,2961000,123,4089000,-43,-1128000,Clackamas County,Clackamas County-Clatsop County-OR
47,Clackamas County-Snohomish County-WA-1718,"Snohomish County, WA",1718,2017,2018,110,4217000,126,4933000,-16,-716000,Clackamas County,Clackamas County-Snohomish County-WA
48,Clackamas County-Ada County-ID-1718,"Ada County, ID",1718,2017,2018,99,3238000,140,4835000,-41,-1597000,Clackamas County,Clackamas County-Ada County-ID
49,Clackamas County-Salt Lake County-UT-1718,"Salt Lake County, UT",1718,2017,2018,97,3263000,84,2301000,13,962000,Clackamas County,Clackamas County-Salt Lake County-UT
50,Clackamas County-Lincoln County-OR-1718,"Lincoln County, OR",1718,2017,2018,88,2887000,141,5080000,-53,-2193000,Clackamas County,Clackamas County-Lincoln County-OR
51,Clackamas County-San Bernardino County-CA-1718,"San Bernardino County, CA",1718,2017,2018,90,3006000,37,1013000,53,1993000,Clackamas County,Clackamas County-San Bernardino County-CA
52,Clackamas County-Sacramento County-CA-1718,"Sacramento County, CA",1718,2017,2018,84,3130000,66,3856000,18,-726000,Clackamas County,Clackamas County-Sacramento County-CA
53,Clackamas County-Spokane County-WA-1718,"Spokane County, WA",1718,2017,2018,74,2257000,127,4305000,-53,-2048000,Clackamas County,Clackamas County-Spokane County-WA
54,Clackamas County-Douglas County-OR-1718,"Douglas County, OR",1718,2017,2018,74,3009000,96,2751000,-22,258000,Clackamas County,Clackamas County-Douglas County-OR
55,Clackamas County-Cowlitz County-WA-1718,"Cowlitz County, WA",1718,2017,2018,67,1632000,124,4295000,-57,-2663000,Clackamas County,Clackamas County-Cowlitz County-WA
56,Clackamas County-Washoe County-NV-1718,"Washoe County, NV",1718,2017,2018,64,1889000,63,2546000,1,-657000,Clackamas County,Clackamas County-Washoe County-NV
57,Clackamas County-Thurston County-WA-1718,"Thurston County, WA",1718,2017,2018,67,2839000,50,1836000,17,1003000,Clackamas County,Clackamas County-Thurston County-WA
58,Clackamas County-Hood River County-OR-1718,"Hood River County, OR",1718,2017,2018,60,1565000,52,1638000,8,-73000,Clackamas County,Clackamas County-Hood River County-OR
59,Clackamas County-Coos County-OR-1718,"Coos County, OR",1718,2017,2018,51,1519000,51,1390000,0,129000,Clackamas County,Clackamas County-Coos County-OR
60,Clackamas County-Josephine County-OR-1718,"Josephine County, OR",1718,2017,2018,58,1278000,40,1488000,18,-210000,Clackamas County,Clackamas County-Josephine County-OR
61,Clackamas County-Wasco County-OR-1718,"Wasco County, OR",1718,2017,2018,50,915000,49,1929000,1,-1014000,Clackamas County,Clackamas County-Wasco County-OR
62,Clackamas County-Tillamook County-OR-1718,"Tillamook County, OR",1718,2017,2018,49,1431000,120,4217000,-71,-2786000,Clackamas County,Clackamas County-Tillamook County-OR
63,Clackamas County-Harris County-TX-1718,"Harris County, TX",1718,2017,2018,55,3310000,50,1868000,5,1442000,Clackamas County,Clackamas County-Harris County-TX
64,Clackamas County-Cook County-IL-1718,"Cook County, IL",1718,2017,2018,52,3458000,47,3337000,5,121000,Clackamas County,Clackamas County-Cook County-IL
65,Clackamas County-Travis County-TX-1718,"Travis County, TX",1718,2017,2018,45,1977000,57,2483000,-12,-506000,Clackamas County,Clackamas County-Travis County-TX
66,Clackamas County-Pima County-AZ-1718,"Pima County, AZ",1718,2017,2018,33,1161000,83,4348000,-50,-3187000,Clackamas County,Clackamas County-Pima County-AZ
67,Clackamas County-Denver County-CO-1718,"Denver County, CO",1718,2017,2018,35,2182000,32,1654000,3,528000,Clackamas County,Clackamas County-Denver County-CO
68,Clackamas County-Benton County-WA-1718,"Benton County, WA",1718,2017,2018,43,2320000,48,2156000,-5,164000,Clackamas County,Clackamas County-Benton County-WA
69,Clackamas County-El Paso County-CO-1718,"El Paso County, CO",1718,2017,2018,50,1160000,43,1296000,7,-136000,Clackamas County,Clackamas County-El Paso County-CO
70,Clackamas County-Jefferson County-OR-1718,"Jefferson County, OR",1718,2017,2018,42,1021000,70,2576000,-28,-1555000,Clackamas County,Clackamas County-Jefferson County-OR
71,Clackamas County-Kitsap County-WA-1718,"Kitsap County, WA",1718,2017,2018,34,1305000,38,3785000,-4,-2480000,Clackamas County,Clackamas County-Kitsap County-WA
73,Clatsop County-Multnomah County-OR-1718,"Multnomah County, OR",1718,2017,2018,270,9223000,132,6879000,138,2344000,Clatsop County,Clatsop County-Multnomah County-OR
74,Clatsop County-Washington County-OR-1718,"Washington County, OR",1718,2017,2018,207,7937000,182,6156000,25,1781000,Clatsop County,Clatsop County-Washington County-OR
75,Clatsop County-Clackamas County-OR-1718,"Clackamas County, OR",1718,2017,2018,123,4089000,80,2961000,43,1128000,Clatsop County,Clatsop County-Clackamas County-OR
76,Clatsop County-Columbia County-OR-1718,"Columbia County, OR",1718,2017,2018,99,2191000,69,1157000,30,1034000,Clatsop County,Clatsop County-Columbia County-OR
77,Clatsop County-Pacific County-WA-1718,"Pacific County, WA",1718,2017,2018,74,1987000,147,3571000,-73,-1584000,Clatsop County,Clatsop County-Pacific County-WA
78,Clatsop County-King County-WA-1718,"King County, WA",1718,2017,2018,63,2952000,43,1258000,20,1694000,Clatsop County,Clatsop County-King County-WA
79,Clatsop County-Cowlitz County-WA-1718,"Cowlitz County, WA",1718,2017,2018,55,1129000,41,583000,14,546000,Clatsop County,Clatsop County-Cowlitz County-WA
80,Clatsop County-Tillamook County-OR-1718,"Tillamook County, OR",1718,2017,2018,51,1076000,45,973000,6,103000,Clatsop County,Clatsop County-Tillamook County-OR
81,Clatsop County-Deschutes County-OR-1718,"Deschutes County, OR",1718,2017,2018,45,1109000,68,2523000,-23,-1414000,Clatsop County,Clatsop County-Deschutes County-OR
82,Clatsop County-Clark County-WA-1718,"Clark County, WA",1718,2017,2018,51,1866000,82,2126000,-31,-260000,Clatsop County,Clatsop County-Clark County-WA
83,Clatsop County-Lane County-OR-1718,"Lane County, OR",1718,2017,2018,48,1174000,55,1001000,-7,173000,Clatsop County,Clatsop County-Lane County-OR
85,Columbia County-Washington County-OR-1718,"Washington County, OR",1718,2017,2018,883,27582000,396,9696000,487,17886000,Columbia County,Columbia County-Washington County-OR
86,Columbia County-Multnomah County-OR-1718,"Multnomah County, OR",1718,2017,2018,638,21080000,300,14228000,338,6852000,Columbia County,Columbia County-Multnomah County-OR
87,Columbia County-Clackamas County-OR-1718,"Clackamas County, OR",1718,2017,2018,170,5916000,135,3327000,35,2589000,Columbia County,Columbia County-Clackamas County-OR
88,Columbia County-Cowlitz County-WA-1718,"Cowlitz County, WA",1718,2017,2018,172,3312000,263,6503000,-91,-3191000,Columbia County,Columbia County-Cowlitz County-WA
89,Columbia County-Clark County-WA-1718,"Clark County, WA",1718,2017,2018,113,3072000,140,3846000,-27,-774000,Columbia County,Columbia County-Clark County-WA
90,Columbia County-Clatsop County-OR-1718,"Clatsop County, OR",1718,2017,2018,69,1157000,99,2191000,-30,-1034000,Columbia County,Columbia County-Clatsop County-OR
91,Columbia County-Lane County-OR-1718,"Lane County, OR",1718,2017,2018,48,1389000,39,953000,9,436000,Columbia County,Columbia County-Lane County-OR
93,Coos County-Lane County-OR-1718,"Lane County, OR",1718,2017,2018,223,4803000,276,7781000,-53,-2978000,Coos County,Coos County-Lane County-OR
94,Coos County-Douglas County-OR-1718,"Douglas County, OR",1718,2017,2018,179,3114000,254,4624000,-75,-1510000,Coos County,Coos County-Douglas County-OR
95,Coos County-Jackson County-OR-1718,"Jackson County, OR",1718,2017,2018,134,2453000,100,1912000,34,541000,Coos County,Coos County-Jackson County-OR
96,Coos County-Multnomah County-OR-1718,"Multnomah County, OR",1718,2017,2018,83,2570000,50,1513000,33,1057000,Coos County,Coos County-Multnomah County-OR
97,Coos County-Curry County-OR-1718,"Curry County, OR",1718,2017,2018,67,1687000,66,1613000,1,74000,Coos County,Coos County-Curry County-OR
98,Coos County-Deschutes County-OR-1718,"Deschutes County, OR",1718,2017,2018,65,1327000,51,1699000,14,-372000,Coos County,Coos County-Deschutes County-OR
99,Coos County-Washington County-OR-1718,"Washington County, OR",1718,2017,2018,54,1611000,61,1864000,-7,-253000,Coos County,Coos County-Washington County-OR
100,Coos County-Clackamas County-OR-1718,"Clackamas County, OR",1718,2017,2018,51,1390000,51,1519000,0,-129000,Coos County,Coos County-Clackamas County-OR
101,Coos County-Marion County-OR-1718,"Marion County, OR",1718,2017,2018,33,715000,59,1114000,-26,-399000,Coos County,Coos County-Marion County-OR
102,Coos County-King County-WA-1718,"King County, WA",1718,2017,2018,28,1099000,30,785000,-2,314000,Coos County,Coos County-King County-WA
104,Crook County-Deschutes County-OR-1718,"Deschutes County, OR",1718,2017,2018,629,18255000,380,9969000,249,8286000,Crook County,Crook County-Deschutes County-OR
105,Crook County-Jefferson County-OR-1718,"Jefferson County, OR",1718,2017,2018,96,2456000,109,1770000,-13,686000,Crook County,Crook County-Jefferson County-OR
107,Curry County-Jackson County-OR-1718,"Jackson County, OR",1718,2017,2018,87,2390000,64,1534000,23,856000,Curry County,Curry County-Jackson County-OR
108,Curry County-Del Norte County-CA-1718,"Del Norte County, CA",1718,2017,2018,81,1622000,55,1415000,26,207000,Curry County,Curry County-Del Norte County-CA
109,Curry County-Coos County-OR-1718,"Coos County, OR",1718,2017,2018,66,1613000,67,1687000,-1,-74000,Curry County,Curry County-Coos County-OR
110,Curry County-Josephine County-OR-1718,"Josephine County, OR",1718,2017,2018,55,1164000,37,939000,18,225000,Curry County,Curry County-Josephine County-OR
112,Deschutes County-Multnomah County-OR-1718,"Multnomah County, OR",1718,2017,2018,732,39799000,385,17111000,347,22688000,Deschutes County,Deschutes County-Multnomah County-OR
113,Deschutes County-Washington County-OR-1718,"Washington County, OR",1718,2017,2018,583,31295000,275,9527000,308,21768000,Deschutes County,Deschutes County-Washington County-OR
114,Deschutes County-Lane County-OR-1718,"Lane County, OR",1718,2017,2018,472,16945000,372,11520000,100,5425000,Deschutes County,Deschutes County-Lane County-OR
115,Deschutes County-Clackamas County-OR-1718,"Clackamas County, OR",1718,2017,2018,532,22748000,277,9679000,255,13069000,Deschutes County,Deschutes County-Clackamas County-OR
116,Deschutes County-King County-WA-1718,"King County, WA",1718,2017,2018,415,35415000,121,6586000,294,28829000,Deschutes County,Deschutes County-King County-WA
117,Deschutes County-Crook County-OR-1718,"Crook County, OR",1718,2017,2018,380,9969000,629,18255000,-249,-8286000,Deschutes County,Deschutes County-Crook County-OR
118,Deschutes County-Jefferson County-OR-1718,"Jefferson County, OR",1718,2017,2018,358,6894000,498,10277000,-140,-3383000,Deschutes County,Deschutes County-Jefferson County-OR
119,Deschutes County-Marion County-OR-1718,"Marion County, OR",1718,2017,2018,360,12887000,246,7366000,114,5521000,Deschutes County,Deschutes County-Marion County-OR
120,Deschutes County-Los Angeles County-CA-1718,"Los Angeles County, CA",1718,2017,2018,329,16233000,79,2818000,250,13415000,Deschutes County,Deschutes County-Los Angeles County-CA
121,Deschutes County-San Diego County-CA-1718,"San Diego County, CA",1718,2017,2018,309,16670000,87,4810000,222,11860000,Deschutes County,Deschutes County-San Diego County-CA
122,Deschutes County-Orange County-CA-1718,"Orange County, CA",1718,2017,2018,272,23151000,45,2097000,227,21054000,Deschutes County,Deschutes County-Orange County-CA
123,Deschutes County-Clark County-WA-1718,"Clark County, WA",1718,2017,2018,249,15019000,180,7765000,69,7254000,Deschutes County,Deschutes County-Clark County-WA
124,Deschutes County-Maricopa County-AZ-1718,"Maricopa County, AZ",1718,2017,2018,210,7943000,246,26137000,-36,-18194000,Deschutes County,Deschutes County-Maricopa County-AZ
125,Deschutes County-Jackson County-OR-1718,"Jackson County, OR",1718,2017,2018,207,8855000,189,5856000,18,2999000,Deschutes County,Deschutes County-Jackson County-OR
126,Deschutes County-Benton County-OR-1718,"Benton County, OR",1718,2017,2018,171,9663000,129,4176000,42,5487000,Deschutes County,Deschutes County-Benton County-OR
127,Deschutes County-Santa Clara County-CA-1718,"Santa Clara County, CA",1718,2017,2018,197,17515000,27,1631000,170,15884000,Deschutes County,Deschutes County-Santa Clara County-CA
128,Deschutes County-Linn County-OR-1718,"Linn County, OR",1718,2017,2018,171,5578000,144,3609000,27,1969000,Deschutes County,Deschutes County-Linn County-OR
129,Deschutes County-Klamath County-OR-1718,"Klamath County, OR",1718,2017,2018,152,3551000,190,4607000,-38,-1056000,Deschutes County,Deschutes County-Klamath County-OR
130,Deschutes County-Riverside County-CA-1718,"Riverside County, CA",1718,2017,2018,156,5817000,81,4558000,75,1259000,Deschutes County,Deschutes County-Riverside County-CA
131,Deschutes County-Clark County-NV-1718,"Clark County, NV",1718,2017,2018,140,4759000,114,3841000,26,918000,Deschutes County,Deschutes County-Clark County-NV
132,Deschutes County-Douglas County-OR-1718,"Douglas County, OR",1718,2017,2018,124,3745000,90,2237000,34,1508000,Deschutes County,Deschutes County-Douglas County-OR
133,Deschutes County-Yamhill County-OR-1718,"Yamhill County, OR",1718,2017,2018,133,5397000,95,2167000,38,3230000,Deschutes County,Deschutes County-Yamhill County-OR
134,Deschutes County-Alameda County-CA-1718,"Alameda County, CA",1718,2017,2018,144,10371000,35,1362000,109,9009000,Deschutes County,Deschutes County-Alameda County-CA
135,Deschutes County-Sonoma County-CA-1718,"Sonoma County, CA",1718,2017,2018,119,4784000,41,2174000,78,2610000,Deschutes County,Deschutes County-Sonoma County-CA
136,Deschutes County-Polk County-OR-1718,"Polk County, OR",1718,2017,2018,107,2970000,78,1771000,29,1199000,Deschutes County,Deschutes County-Polk County-OR
137,Deschutes County-Pierce County-WA-1718,"Pierce County, WA",1718,2017,2018,110,6218000,61,2497000,49,3721000,Deschutes County,Deschutes County-Pierce County-WA
138,Deschutes County-Ada County-ID-1718,"Ada County, ID",1718,2017,2018,106,3660000,160,5877000,-54,-2217000,Deschutes County,Deschutes County-Ada County-ID
139,Deschutes County-Lincoln County-OR-1718,"Lincoln County, OR",1718,2017,2018,70,2275000,118,2955000,-48,-680000,Deschutes County,Deschutes County-Lincoln County-OR
140,Deschutes County-Clatsop County-OR-1718,"Clatsop County, OR",1718,2017,2018,68,2523000,45,1109000,23,1414000,Deschutes County,Deschutes County-Clatsop County-OR
141,Deschutes County-Josephine County-OR-1718,"Josephine County, OR",1718,2017,2018,54,1252000,71,1248000,-17,4000,Deschutes County,Deschutes County-Josephine County-OR
142,Deschutes County-Travis County-TX-1718,"Travis County, TX",1718,2017,2018,59,3139000,56,1697000,3,1442000,Deschutes County,Deschutes County-Travis County-TX
143,Deschutes County-Spokane County-WA-1718,"Spokane County, WA",1718,2017,2018,54,2110000,73,1906000,-19,204000,Deschutes County,Deschutes County-Spokane County-WA
144,Deschutes County-Coos County-OR-1718,"Coos County, OR",1718,2017,2018,51,1699000,65,1327000,-14,372000,Deschutes County,Deschutes County-Coos County-OR
145,Deschutes County-Salt Lake County-UT-1718,"Salt Lake County, UT",1718,2017,2018,54,2323000,50,1655000,4,668000,Deschutes County,Deschutes County-Salt Lake County-UT
146,Deschutes County-Washoe County-NV-1718,"Washoe County, NV",1718,2017,2018,41,3302000,60,1980000,-19,1322000,Deschutes County,Deschutes County-Washoe County-NV
147,Deschutes County-San Luis Obispo County-CA-1718,"San Luis Obispo County, CA",1718,2017,2018,45,1346000,32,850000,13,496000,Deschutes County,Deschutes County-San Luis Obispo County-CA
148,Deschutes County-Thurston County-WA-1718,"Thurston County, WA",1718,2017,2018,44,2221000,35,1115000,9,1106000,Deschutes County,Deschutes County-Thurston County-WA
149,Deschutes County-Umatilla County-OR-1718,"Umatilla County, OR",1718,2017,2018,46,1249000,46,1478000,0,-229000,Deschutes County,Deschutes County-Umatilla County-OR
150,Deschutes County-Wasco County-OR-1718,"Wasco County, OR",1718,2017,2018,41,1195000,48,2244000,-7,-1049000,Deschutes County,Deschutes County-Wasco County-OR
151,Deschutes County-Benton County-WA-1718,"Benton County, WA",1718,2017,2018,41,1808000,35,1198000,6,610000,Deschutes County,Deschutes County-Benton County-WA
152,Deschutes County-Pima County-AZ-1718,"Pima County, AZ",1718,2017,2018,42,1564000,90,4364000,-48,-2800000,Deschutes County,Deschutes County-Pima County-AZ
153,Deschutes County-Canyon County-ID-1718,"Canyon County, ID",1718,2017,2018,32,682000,47,1274000,-15,-592000,Deschutes County,Deschutes County-Canyon County-ID
155,Douglas County-Lane County-OR-1718,"Lane County, OR",1718,2017,2018,564,12146000,552,14661000,12,-2515000,Douglas County,Douglas County-Lane County-OR
156,Douglas County-Coos County-OR-1718,"Coos County, OR",1718,2017,2018,254,4624000,179,3114000,75,1510000,Douglas County,Douglas County-Coos County-OR
157,Douglas County-Jackson County-OR-1718,"Jackson County, OR",1718,2017,2018,214,4301000,165,3887000,49,414000,Douglas County,Douglas County-Jackson County-OR
158,Douglas County-Josephine County-OR-1718,"Josephine County, OR",1718,2017,2018,158,2994000,149,3316000,9,-322000,Douglas County,Douglas County-Josephine County-OR
159,Douglas County-Multnomah County-OR-1718,"Multnomah County, OR",1718,2017,2018,109,3220000,119,3465000,-10,-245000,Douglas County,Douglas County-Multnomah County-OR
160,Douglas County-Linn County-OR-1718,"Linn County, OR",1718,2017,2018,91,1916000,70,1338000,21,578000,Douglas County,Douglas County-Linn County-OR
161,Douglas County-Klamath County-OR-1718,"Klamath County, OR",1718,2017,2018,88,2197000,51,1198000,37,999000,Douglas County,Douglas County-Klamath County-OR
162,Douglas County-Deschutes County-OR-1718,"Deschutes County, OR",1718,2017,2018,90,2237000,124,3745000,-34,-1508000,Douglas County,Douglas County-Deschutes County-OR
163,Douglas County-Clackamas County-OR-1718,"Clackamas County, OR",1718,2017,2018,96,2751000,74,3009000,22,-258000,Douglas County,Douglas County-Clackamas County-OR
164,Douglas County-Washington County-OR-1718,"Washington County, OR",1718,2017,2018,81,2575000,77,1946000,4,629000,Douglas County,Douglas County-Washington County-OR
165,Douglas County-Marion County-OR-1718,"Marion County, OR",1718,2017,2018,67,2228000,86,2339000,-19,-111000,Douglas County,Douglas County-Marion County-OR
166,Douglas County-Maricopa County-AZ-1718,"Maricopa County, AZ",1718,2017,2018,65,1503000,74,3073000,-9,-1570000,Douglas County,Douglas County-Maricopa County-AZ
167,Douglas County-San Diego County-CA-1718,"San Diego County, CA",1718,2017,2018,58,1608000,31,688000,27,920000,Douglas County,Douglas County-San Diego County-CA
168,Douglas County-Benton County-OR-1718,"Benton County, OR",1718,2017,2018,44,979000,73,1699000,-29,-720000,Douglas County,Douglas County-Benton County-OR
169,Douglas County-King County-WA-1718,"King County, WA",1718,2017,2018,44,1304000,40,1100000,4,204000,Douglas County,Douglas County-King County-WA
170,Douglas County-Clark County-NV-1718,"Clark County, NV",1718,2017,2018,52,1892000,56,946000,-4,946000,Douglas County,Douglas County-Clark County-NV
171,Douglas County-Pierce County-WA-1718,"Pierce County, WA",1718,2017,2018,38,834000,39,1232000,-1,-398000,Douglas County,Douglas County-Pierce County-WA
176,Hood River County-Multnomah County-OR-1718,"Multnomah County, OR",1718,2017,2018,222,9140000,148,4264000,74,4876000,Hood River County,Hood River County-Multnomah County-OR
177,Hood River County-Wasco County-OR-1718,"Wasco County, OR",1718,2017,2018,141,3474000,264,5885000,-123,-2411000,Hood River County,Hood River County-Wasco County-OR
178,Hood River County-Klickitat County-WA-1718,"Klickitat County, WA",1718,2017,2018,118,3346000,128,4319000,-10,-973000,Hood River County,Hood River County-Klickitat County-WA
179,Hood River County-Washington County-OR-1718,"Washington County, OR",1718,2017,2018,57,3010000,48,843000,9,2167000,Hood River County,Hood River County-Washington County-OR
180,Hood River County-Clackamas County-OR-1718,"Clackamas County, OR",1718,2017,2018,52,1638000,60,1565000,-8,73000,Hood River County,Hood River County-Clackamas County-OR
182,Jackson County-Josephine County-OR-1718,"Josephine County, OR",1718,2017,2018,974,22115000,903,20367000,71,1748000,Jackson County,Jackson County-Josephine County-OR
183,Jackson County-Multnomah County-OR-1718,"Multnomah County, OR",1718,2017,2018,258,9694000,311,10359000,-53,-665000,Jackson County,Jackson County-Multnomah County-OR
184,Jackson County-Lane County-OR-1718,"Lane County, OR",1718,2017,2018,316,8008000,382,9576000,-66,-1568000,Jackson County,Jackson County-Lane County-OR
185,Jackson County-Los Angeles County-CA-1718,"Los Angeles County, CA",1718,2017,2018,325,14490000,151,4304000,174,10186000,Jackson County,Jackson County-Los Angeles County-CA
186,Jackson County-Klamath County-OR-1718,"Klamath County, OR",1718,2017,2018,261,6790000,264,6219000,-3,571000,Jackson County,Jackson County-Klamath County-OR
187,Jackson County-Deschutes County-OR-1718,"Deschutes County, OR",1718,2017,2018,189,5856000,207,8855000,-18,-2999000,Jackson County,Jackson County-Deschutes County-OR
188,Jackson County-Washington County-OR-1718,"Washington County, OR",1718,2017,2018,172,5487000,198,6401000,-26,-914000,Jackson County,Jackson County-Washington County-OR
189,Jackson County-Santa Clara County-CA-1718,"Santa Clara County, CA",1718,2017,2018,177,13144000,33,1750000,144,11394000,Jackson County,Jackson County-Santa Clara County-CA
190,Jackson County-San Diego County-CA-1718,"San Diego County, CA",1718,2017,2018,181,6561000,73,3072000,108,3489000,Jackson County,Jackson County-San Diego County-CA
191,Jackson County-Douglas County-OR-1718,"Douglas County, OR",1718,2017,2018,165,3887000,214,4301000,-49,-414000,Jackson County,Jackson County-Douglas County-OR
192,Jackson County-Alameda County-CA-1718,"Alameda County, CA",1718,2017,2018,139,9615000,34,1754000,105,7861000,Jackson County,Jackson County-Alameda County-CA
193,Jackson County-Siskiyou County-CA-1718,"Siskiyou County, CA",1718,2017,2018,148,3070000,89,2267000,59,803000,Jackson County,Jackson County-Siskiyou County-CA
194,Jackson County-King County-WA-1718,"King County, WA",1718,2017,2018,145,5109000,85,3430000,60,1679000,Jackson County,Jackson County-King County-WA
195,Jackson County-Clackamas County-OR-1718,"Clackamas County, OR",1718,2017,2018,116,5848000,145,4764000,-29,1084000,Jackson County,Jackson County-Clackamas County-OR
196,Jackson County-Orange County-CA-1718,"Orange County, CA",1718,2017,2018,106,2793000,67,1402000,39,1391000,Jackson County,Jackson County-Orange County-CA
197,Jackson County-Marion County-OR-1718,"Marion County, OR",1718,2017,2018,106,2806000,138,4046000,-32,-1240000,Jackson County,Jackson County-Marion County-OR
198,Jackson County-Sacramento County-CA-1718,"Sacramento County, CA",1718,2017,2018,116,3746000,85,2102000,31,1644000,Jackson County,Jackson County-Sacramento County-CA
199,Jackson County-Sonoma County-CA-1718,"Sonoma County, CA",1718,2017,2018,130,4556000,30,1045000,100,3511000,Jackson County,Jackson County-Sonoma County-CA
200,Jackson County-Clark County-NV-1718,"Clark County, NV",1718,2017,2018,99,2858000,120,4224000,-21,-1366000,Jackson County,Jackson County-Clark County-NV
201,Jackson County-Contra Costa County-CA-1718,"Contra Costa County, CA",1718,2017,2018,100,5233000,33,1065000,67,4168000,Jackson County,Jackson County-Contra Costa County-CA
202,Jackson County-Maricopa County-AZ-1718,"Maricopa County, AZ",1718,2017,2018,106,2826000,196,7089000,-90,-4263000,Jackson County,Jackson County-Maricopa County-AZ
203,Jackson County-Riverside County-CA-1718,"Riverside County, CA",1718,2017,2018,113,4167000,49,844000,64,3323000,Jackson County,Jackson County-Riverside County-CA
204,Jackson County-Coos County-OR-1718,"Coos County, OR",1718,2017,2018,100,1912000,134,2453000,-34,-541000,Jackson County,Jackson County-Coos County-OR
205,Jackson County-Shasta County-CA-1718,"Shasta County, CA",1718,2017,2018,90,2076000,55,1448000,35,628000,Jackson County,Jackson County-Shasta County-CA
206,Jackson County-Curry County-OR-1718,"Curry County, OR",1718,2017,2018,64,1534000,87,2390000,-23,-856000,Jackson County,Jackson County-Curry County-OR
207,Jackson County-Benton County-OR-1718,"Benton County, OR",1718,2017,2018,53,1928000,81,1468000,-28,460000,Jackson County,Jackson County-Benton County-OR
208,Jackson County-Butte County-CA-1718,"Butte County, CA",1718,2017,2018,55,1840000,41,1378000,14,462000,Jackson County,Jackson County-Butte County-CA
209,Jackson County-Clark County-WA-1718,"Clark County, WA",1718,2017,2018,59,4278000,95,2254000,-36,2024000,Jackson County,Jackson County-Clark County-WA
210,Jackson County-Pierce County-WA-1718,"Pierce County, WA",1718,2017,2018,49,815000,67,2378000,-18,-1563000,Jackson County,Jackson County-Pierce County-WA
211,Jackson County-Washoe County-NV-1718,"Washoe County, NV",1718,2017,2018,49,1153000,51,1393000,-2,-240000,Jackson County,Jackson County-Washoe County-NV
212,Jackson County-Ventura County-CA-1718,"Ventura County, CA",1718,2017,2018,47,2048000,35,703000,12,1345000,Jackson County,Jackson County-Ventura County-CA
213,Jackson County-Linn County-OR-1718,"Linn County, OR",1718,2017,2018,49,1252000,86,1788000,-37,-536000,Jackson County,Jackson County-Linn County-OR
214,Jackson County-Pima County-AZ-1718,"Pima County, AZ",1718,2017,2018,39,825000,55,988000,-16,-163000,Jackson County,Jackson County-Pima County-AZ
215,Jackson County-Ada County-ID-1718,"Ada County, ID",1718,2017,2018,40,689000,57,4464000,-17,-3775000,Jackson County,Jackson County-Ada County-ID
217,Jefferson County-Deschutes County-OR-1718,"Deschutes County, OR",1718,2017,2018,498,10277000,358,6894000,140,3383000,Jefferson County,Jefferson County-Deschutes County-OR
218,Jefferson County-Crook County-OR-1718,"Crook County, OR",1718,2017,2018,109,1770000,96,2456000,13,-686000,Jefferson County,Jefferson County-Crook County-OR
219,Jefferson County-Multnomah County-OR-1718,"Multnomah County, OR",1718,2017,2018,76,2307000,41,988000,35,1319000,Jefferson County,Jefferson County-Multnomah County-OR
220,Jefferson County-Clackamas County-OR-1718,"Clackamas County, OR",1718,2017,2018,70,2576000,42,1021000,28,1555000,Jefferson County,Jefferson County-Clackamas County-OR
222,Josephine County-Jackson County-OR-1718,"Jackson County, OR",1718,2017,2018,903,20367000,974,22115000,-71,-1748000,Josephine County,Josephine County-Jackson County-OR
223,Josephine County-Douglas County-OR-1718,"Douglas County, OR",1718,2017,2018,149,3316000,158,2994000,-9,322000,Josephine County,Josephine County-Douglas County-OR
224,Josephine County-Los Angeles County-CA-1718,"Los Angeles County, CA",1718,2017,2018,129,5253000,43,1145000,86,4108000,Josephine County,Josephine County-Los Angeles County-CA
225,Josephine County-Lane County-OR-1718,"Lane County, OR",1718,2017,2018,102,2073000,122,4938000,-20,-2865000,Josephine County,Josephine County-Lane County-OR
226,Josephine County-Multnomah County-OR-1718,"Multnomah County, OR",1718,2017,2018,57,1310000,82,2095000,-25,-785000,Josephine County,Josephine County-Multnomah County-OR
227,Josephine County-San Diego County-CA-1718,"San Diego County, CA",1718,2017,2018,71,2775000,37,908000,34,1867000,Josephine County,Josephine County-San Diego County-CA
228,Josephine County-Deschutes County-OR-1718,"Deschutes County, OR",1718,2017,2018,71,1248000,54,1252000,17,-4000,Josephine County,Josephine County-Deschutes County-OR
229,Josephine County-Klamath County-OR-1718,"Klamath County, OR",1718,2017,2018,63,1178000,57,983000,6,195000,Josephine County,Josephine County-Klamath County-OR
230,Josephine County-Maricopa County-AZ-1718,"Maricopa County, AZ",1718,2017,2018,66,2626000,72,2114000,-6,512000,Josephine County,Josephine County-Maricopa County-AZ
231,Josephine County-Riverside County-CA-1718,"Riverside County, CA",1718,2017,2018,53,1402000,36,438000,17,964000,Josephine County,Josephine County-Riverside County-CA
232,Josephine County-Washington County-OR-1718,"Washington County, OR",1718,2017,2018,58,1410000,47,1042000,11,368000,Josephine County,Josephine County-Washington County-OR
233,Josephine County-Clackamas County-OR-1718,"Clackamas County, OR",1718,2017,2018,40,1488000,58,1278000,-18,210000,Josephine County,Josephine County-Clackamas County-OR
234,Josephine County-Marion County-OR-1718,"Marion County, OR",1718,2017,2018,52,1140000,57,1425000,-5,-285000,Josephine County,Josephine County-Marion County-OR
235,Josephine County-Curry County-OR-1718,"Curry County, OR",1718,2017,2018,37,939000,55,1164000,-18,-225000,Josephine County,Josephine County-Curry County-OR
236,Josephine County-Clark County-NV-1718,"Clark County, NV",1718,2017,2018,40,675000,28,675000,12,0,Josephine County,Josephine County-Clark County-NV
238,Klamath County-Jackson County-OR-1718,"Jackson County, OR",1718,2017,2018,264,6219000,261,6790000,3,-571000,Klamath County,Klamath County-Jackson County-OR
239,Klamath County-Deschutes County-OR-1718,"Deschutes County, OR",1718,2017,2018,190,4607000,152,3551000,38,1056000,Klamath County,Klamath County-Deschutes County-OR
240,Klamath County-Lane County-OR-1718,"Lane County, OR",1718,2017,2018,104,2006000,152,3491000,-48,-1485000,Klamath County,Klamath County-Lane County-OR
241,Klamath County-Siskiyou County-CA-1718,"Siskiyou County, CA",1718,2017,2018,125,2123000,96,1297000,29,826000,Klamath County,Klamath County-Siskiyou County-CA
242,Klamath County-Multnomah County-OR-1718,"Multnomah County, OR",1718,2017,2018,73,1255000,68,2014000,5,-759000,Klamath County,Klamath County-Multnomah County-OR
243,Klamath County-Marion County-OR-1718,"Marion County, OR",1718,2017,2018,82,1460000,63,1326000,19,134000,Klamath County,Klamath County-Marion County-OR
244,Klamath County-Shasta County-CA-1718,"Shasta County, CA",1718,2017,2018,62,1413000,37,840000,25,573000,Klamath County,Klamath County-Shasta County-CA
245,Klamath County-Josephine County-OR-1718,"Josephine County, OR",1718,2017,2018,57,983000,63,1178000,-6,-195000,Klamath County,Klamath County-Josephine County-OR
246,Klamath County-Douglas County-OR-1718,"Douglas County, OR",1718,2017,2018,51,1198000,88,2197000,-37,-999000,Klamath County,Klamath County-Douglas County-OR
247,Klamath County-Washington County-OR-1718,"Washington County, OR",1718,2017,2018,46,1116000,88,2327000,-42,-1211000,Klamath County,Klamath County-Washington County-OR
248,Klamath County-Linn County-OR-1718,"Linn County, OR",1718,2017,2018,43,1007000,63,1475000,-20,-468000,Klamath County,Klamath County-Linn County-OR
249,Klamath County-King County-WA-1718,"King County, WA",1718,2017,2018,39,1521000,30,657000,9,864000,Klamath County,Klamath County-King County-WA
252,Lane County-Multnomah County-OR-1718,"Multnomah County, OR",1718,2017,2018,684,21619000,847,24721000,-163,-3102000,Lane County,Lane County-Multnomah County-OR
253,Lane County-Linn County-OR-1718,"Linn County, OR",1718,2017,2018,591,14419000,816,20166000,-225,-5747000,Lane County,Lane County-Linn County-OR
254,Lane County-Douglas County-OR-1718,"Douglas County, OR",1718,2017,2018,552,14661000,564,12146000,-12,2515000,Lane County,Lane County-Douglas County-OR
255,Lane County-Washington County-OR-1718,"Washington County, OR",1718,2017,2018,437,14487000,496,13580000,-59,907000,Lane County,Lane County-Washington County-OR
256,Lane County-Marion County-OR-1718,"Marion County, OR",1718,2017,2018,465,12725000,454,10816000,11,1909000,Lane County,Lane County-Marion County-OR
257,Lane County-Benton County-OR-1718,"Benton County, OR",1718,2017,2018,353,9958000,392,9846000,-39,112000,Lane County,Lane County-Benton County-OR
258,Lane County-Los Angeles County-CA-1718,"Los Angeles County, CA",1718,2017,2018,383,12194000,182,4276000,201,7918000,Lane County,Lane County-Los Angeles County-CA
259,Lane County-Jackson County-OR-1718,"Jackson County, OR",1718,2017,2018,382,9576000,316,8008000,66,1568000,Lane County,Lane County-Jackson County-OR
260,Lane County-Deschutes County-OR-1718,"Deschutes County, OR",1718,2017,2018,372,11520000,472,16945000,-100,-5425000,Lane County,Lane County-Deschutes County-OR
261,Lane County-King County-WA-1718,"King County, WA",1718,2017,2018,256,11364000,233,8027000,23,3337000,Lane County,Lane County-King County-WA
262,Lane County-Clackamas County-OR-1718,"Clackamas County, OR",1718,2017,2018,268,9553000,349,14240000,-81,-4687000,Lane County,Lane County-Clackamas County-OR
263,Lane County-Coos County-OR-1718,"Coos County, OR",1718,2017,2018,276,7781000,223,4803000,53,2978000,Lane County,Lane County-Coos County-OR
264,Lane County-San Diego County-CA-1718,"San Diego County, CA",1718,2017,2018,237,7637000,124,4805000,113,2832000,Lane County,Lane County-San Diego County-CA
265,Lane County-Maricopa County-AZ-1718,"Maricopa County, AZ",1718,2017,2018,245,7889000,273,9590000,-28,-1701000,Lane County,Lane County-Maricopa County-AZ
266,Lane County-Orange County-CA-1718,"Orange County, CA",1718,2017,2018,212,9477000,111,3561000,101,5916000,Lane County,Lane County-Orange County-CA
267,Lane County-Lincoln County-OR-1718,"Lincoln County, OR",1718,2017,2018,164,4760000,145,5398000,19,-638000,Lane County,Lane County-Lincoln County-OR
268,Lane County-Santa Clara County-CA-1718,"Santa Clara County, CA",1718,2017,2018,155,8760000,62,2188000,93,6572000,Lane County,Lane County-Santa Clara County-CA
269,Lane County-Clark County-WA-1718,"Clark County, WA",1718,2017,2018,171,4872000,248,7589000,-77,-2717000,Lane County,Lane County-Clark County-WA
270,Lane County-Klamath County-OR-1718,"Klamath County, OR",1718,2017,2018,152,3491000,104,2006000,48,1485000,Lane County,Lane County-Klamath County-OR
271,Lane County-Alameda County-CA-1718,"Alameda County, CA",1718,2017,2018,145,5839000,50,1583000,95,4256000,Lane County,Lane County-Alameda County-CA
272,Lane County-Sacramento County-CA-1718,"Sacramento County, CA",1718,2017,2018,127,4831000,48,963000,79,3868000,Lane County,Lane County-Sacramento County-CA
273,Lane County-Riverside County-CA-1718,"Riverside County, CA",1718,2017,2018,139,3868000,89,2283000,50,1585000,Lane County,Lane County-Riverside County-CA
274,Lane County-Clark County-NV-1718,"Clark County, NV",1718,2017,2018,150,3880000,141,3250000,9,630000,Lane County,Lane County-Clark County-NV
275,Lane County-Josephine County-OR-1718,"Josephine County, OR",1718,2017,2018,122,4938000,102,2073000,20,2865000,Lane County,Lane County-Josephine County-OR
276,Lane County-Polk County-OR-1718,"Polk County, OR",1718,2017,2018,128,2959000,116,3045000,12,-86000,Lane County,Lane County-Polk County-OR
277,Lane County-Pierce County-WA-1718,"Pierce County, WA",1718,2017,2018,142,5064000,117,3943000,25,1121000,Lane County,Lane County-Pierce County-WA
278,Lane County-San Bernardino County-CA-1718,"San Bernardino County, CA",1718,2017,2018,117,2875000,42,713000,75,2162000,Lane County,Lane County-San Bernardino County-CA
279,Lane County-Contra Costa County-CA-1718,"Contra Costa County, CA",1718,2017,2018,110,4093000,61,2211000,49,1882000,Lane County,Lane County-Contra Costa County-CA
280,Lane County-Salt Lake County-UT-1718,"Salt Lake County, UT",1718,2017,2018,106,2498000,71,2497000,35,1000,Lane County,Lane County-Salt Lake County-UT
281,Lane County-Sonoma County-CA-1718,"Sonoma County, CA",1718,2017,2018,85,2831000,42,936000,43,1895000,Lane County,Lane County-Sonoma County-CA
282,Lane County-Snohomish County-WA-1718,"Snohomish County, WA",1718,2017,2018,98,2931000,71,1922000,27,1009000,Lane County,Lane County-Snohomish County-WA
283,Lane County-Cook County-IL-1718,"Cook County, IL",1718,2017,2018,75,3413000,48,1209000,27,2204000,Lane County,Lane County-Cook County-IL
284,Lane County-Yamhill County-OR-1718,"Yamhill County, OR",1718,2017,2018,79,2001000,96,2538000,-17,-537000,Lane County,Lane County-Yamhill County-OR
285,Lane County-Honolulu County-HI-1718,"Honolulu County, HI",1718,2017,2018,88,3040000,66,1437000,22,1603000,Lane County,Lane County-Honolulu County-HI
286,Lane County-Washoe County-NV-1718,"Washoe County, NV",1718,2017,2018,77,2016000,50,1037000,27,979000,Lane County,Lane County-Washoe County-NV
287,Lane County-Travis County-TX-1718,"Travis County, TX",1718,2017,2018,53,1631000,53,1936000,0,-305000,Lane County,Lane County-Travis County-TX
288,Lane County-Ada County-ID-1718,"Ada County, ID",1718,2017,2018,61,1529000,122,2620000,-61,-1091000,Lane County,Lane County-Ada County-ID
289,Lane County-Butte County-CA-1718,"Butte County, CA",1718,2017,2018,63,1712000,46,1184000,17,528000,Lane County,Lane County-Butte County-CA
290,Lane County-Shasta County-CA-1718,"Shasta County, CA",1718,2017,2018,65,2009000,51,1199000,14,810000,Lane County,Lane County-Shasta County-CA
291,Lane County-Anchorage Municipality-AK-1718,"Anchorage Municipality, AK",1718,2017,2018,54,2207000,33,1109000,21,1098000,Lane County,Lane County-Anchorage Municipality-AK
292,Lane County-Pima County-AZ-1718,"Pima County, AZ",1718,2017,2018,59,1685000,79,3510000,-20,-1825000,Lane County,Lane County-Pima County-AZ
293,Lane County-San Mateo County-CA-1718,"San Mateo County, CA",1718,2017,2018,66,2882000,29,1022000,37,1860000,Lane County,Lane County-San Mateo County-CA
294,Lane County-Clatsop County-OR-1718,"Clatsop County, OR",1718,2017,2018,55,1001000,48,1174000,7,-173000,Lane County,Lane County-Clatsop County-OR
295,Lane County-Spokane County-WA-1718,"Spokane County, WA",1718,2017,2018,51,1882000,134,3790000,-83,-1908000,Lane County,Lane County-Spokane County-WA
296,Lane County-El Paso County-CO-1718,"El Paso County, CO",1718,2017,2018,64,1694000,38,576000,26,1118000,Lane County,Lane County-El Paso County-CO
297,Lane County-Umatilla County-OR-1718,"Umatilla County, OR",1718,2017,2018,50,1214000,48,1086000,2,128000,Lane County,Lane County-Umatilla County-OR
298,Lane County-Thurston County-WA-1718,"Thurston County, WA",1718,2017,2018,50,1300000,69,2051000,-19,-751000,Lane County,Lane County-Thurston County-WA
299,Lane County-Canyon County-ID-1718,"Canyon County, ID",1718,2017,2018,54,812000,43,761000,11,51000,Lane County,Lane County-Canyon County-ID
300,Lane County-Denver County-CO-1718,"Denver County, CO",1718,2017,2018,32,1182000,30,927000,2,255000,Lane County,Lane County-Denver County-CO
301,Lane County-Kitsap County-WA-1718,"Kitsap County, WA",1718,2017,2018,58,1294000,35,1111000,23,183000,Lane County,Lane County-Kitsap County-WA
302,Lane County-Columbia County-OR-1718,"Columbia County, OR",1718,2017,2018,39,953000,48,1389000,-9,-436000,Lane County,Lane County-Columbia County-OR
303,Lane County-Hawaii County-HI-1718,"Hawaii County, HI",1718,2017,2018,29,1079000,35,757000,-6,322000,Lane County,Lane County-Hawaii County-HI
305,Lincoln County-Multnomah County-OR-1718,"Multnomah County, OR",1718,2017,2018,192,6710000,84,4084000,108,2626000,Lincoln County,Lincoln County-Multnomah County-OR
306,Lincoln County-Washington County-OR-1718,"Washington County, OR",1718,2017,2018,161,6362000,117,6146000,44,216000,Lincoln County,Lincoln County-Washington County-OR
307,Lincoln County-Lane County-OR-1718,"Lane County, OR",1718,2017,2018,145,5398000,164,4760000,-19,638000,Lincoln County,Lincoln County-Lane County-OR
308,Lincoln County-Clackamas County-OR-1718,"Clackamas County, OR",1718,2017,2018,141,5080000,88,2887000,53,2193000,Lincoln County,Lincoln County-Clackamas County-OR
309,Lincoln County-Marion County-OR-1718,"Marion County, OR",1718,2017,2018,132,2896000,177,3792000,-45,-896000,Lincoln County,Lincoln County-Marion County-OR
310,Lincoln County-Benton County-OR-1718,"Benton County, OR",1718,2017,2018,103,3553000,127,3865000,-24,-312000,Lincoln County,Lincoln County-Benton County-OR
311,Lincoln County-Deschutes County-OR-1718,"Deschutes County, OR",1718,2017,2018,118,2955000,70,2275000,48,680000,Lincoln County,Lincoln County-Deschutes County-OR
312,Lincoln County-Linn County-OR-1718,"Linn County, OR",1718,2017,2018,113,2279000,114,2196000,-1,83000,Lincoln County,Lincoln County-Linn County-OR
313,Lincoln County-Yamhill County-OR-1718,"Yamhill County, OR",1718,2017,2018,77,2137000,57,1365000,20,772000,Lincoln County,Lincoln County-Yamhill County-OR
314,Lincoln County-Polk County-OR-1718,"Polk County, OR",1718,2017,2018,58,1896000,106,2415000,-48,-519000,Lincoln County,Lincoln County-Polk County-OR
315,Lincoln County-Clark County-WA-1718,"Clark County, WA",1718,2017,2018,53,1430000,64,2068000,-11,-638000,Lincoln County,Lincoln County-Clark County-WA
316,Lincoln County-Maricopa County-AZ-1718,"Maricopa County, AZ",1718,2017,2018,52,2046000,56,2401000,-4,-355000,Lincoln County,Lincoln County-Maricopa County-AZ
317,Lincoln County-Tillamook County-OR-1718,"Tillamook County, OR",1718,2017,2018,41,887000,58,2278000,-17,-1391000,Lincoln County,Lincoln County-Tillamook County-OR
319,Linn County-Benton County-OR-1718,"Benton County, OR",1718,2017,2018,1380,42582000,989,24061000,391,18521000,Linn County,Linn County-Benton County-OR
320,Linn County-Marion County-OR-1718,"Marion County, OR",1718,2017,2018,1260,31642000,934,20662000,326,10980000,Linn County,Linn County-Marion County-OR
321,Linn County-Lane County-OR-1718,"Lane County, OR",1718,2017,2018,816,20166000,591,14419000,225,5747000,Linn County,Linn County-Lane County-OR
322,Linn County-Polk County-OR-1718,"Polk County, OR",1718,2017,2018,264,7111000,173,3881000,91,3230000,Linn County,Linn County-Polk County-OR
323,Linn County-Multnomah County-OR-1718,"Multnomah County, OR",1718,2017,2018,208,5919000,124,2961000,84,2958000,Linn County,Linn County-Multnomah County-OR
324,Linn County-Clackamas County-OR-1718,"Clackamas County, OR",1718,2017,2018,186,5955000,141,4067000,45,1888000,Linn County,Linn County-Clackamas County-OR
325,Linn County-Washington County-OR-1718,"Washington County, OR",1718,2017,2018,180,4625000,143,3817000,37,808000,Linn County,Linn County-Washington County-OR
326,Linn County-Deschutes County-OR-1718,"Deschutes County, OR",1718,2017,2018,144,3609000,171,5578000,-27,-1969000,Linn County,Linn County-Deschutes County-OR
327,Linn County-Lincoln County-OR-1718,"Lincoln County, OR",1718,2017,2018,114,2196000,113,2279000,1,-83000,Linn County,Linn County-Lincoln County-OR
328,Linn County-Clark County-WA-1718,"Clark County, WA",1718,2017,2018,89,2279000,85,2413000,4,-134000,Linn County,Linn County-Clark County-WA
329,Linn County-Jackson County-OR-1718,"Jackson County, OR",1718,2017,2018,86,1788000,49,1252000,37,536000,Linn County,Linn County-Jackson County-OR
330,Linn County-Maricopa County-AZ-1718,"Maricopa County, AZ",1718,2017,2018,65,1683000,74,1418000,-9,265000,Linn County,Linn County-Maricopa County-AZ
331,Linn County-Yamhill County-OR-1718,"Yamhill County, OR",1718,2017,2018,70,2219000,41,966000,29,1253000,Linn County,Linn County-Yamhill County-OR
332,Linn County-Douglas County-OR-1718,"Douglas County, OR",1718,2017,2018,70,1338000,91,1916000,-21,-578000,Linn County,Linn County-Douglas County-OR
333,Linn County-King County-WA-1718,"King County, WA",1718,2017,2018,52,3001000,42,1110000,10,1891000,Linn County,Linn County-King County-WA
334,Linn County-Klamath County-OR-1718,"Klamath County, OR",1718,2017,2018,63,1475000,43,1007000,20,468000,Linn County,Linn County-Klamath County-OR
335,Linn County-Pierce County-WA-1718,"Pierce County, WA",1718,2017,2018,54,1049000,35,881000,19,168000,Linn County,Linn County-Pierce County-WA
337,Malheur County-Payette County-ID-1718,"Payette County, ID",1718,2017,2018,329,4514000,334,8179000,-5,-3665000,Malheur County,Malheur County-Payette County-ID
338,Malheur County-Canyon County-ID-1718,"Canyon County, ID",1718,2017,2018,199,3467000,178,2934000,21,533000,Malheur County,Malheur County-Canyon County-ID
339,Malheur County-Ada County-ID-1718,"Ada County, ID",1718,2017,2018,118,2311000,111,1943000,7,368000,Malheur County,Malheur County-Ada County-ID
341,Marion County-Polk County-OR-1718,"Polk County, OR",1718,2017,2018,2302,62025000,2338,57228000,-36,4797000,Marion County,Marion County-Polk County-OR
342,Marion County-Clackamas County-OR-1718,"Clackamas County, OR",1718,2017,2018,1770,48263000,1233,38326000,537,9937000,Marion County,Marion County-Clackamas County-OR
343,Marion County-Washington County-OR-1718,"Washington County, OR",1718,2017,2018,1313,37109000,893,25130000,420,11979000,Marion County,Marion County-Washington County-OR
344,Marion County-Multnomah County-OR-1718,"Multnomah County, OR",1718,2017,2018,974,28470000,798,22796000,176,5674000,Marion County,Marion County-Multnomah County-OR
345,Marion County-Linn County-OR-1718,"Linn County, OR",1718,2017,2018,934,20662000,1260,31642000,-326,-10980000,Marion County,Marion County-Linn County-OR
346,Marion County-Lane County-OR-1718,"Lane County, OR",1718,2017,2018,454,10816000,465,12725000,-11,-1909000,Marion County,Marion County-Lane County-OR
347,Marion County-Yamhill County-OR-1718,"Yamhill County, OR",1718,2017,2018,458,11891000,446,10129000,12,1762000,Marion County,Marion County-Yamhill County-OR
348,Marion County-Benton County-OR-1718,"Benton County, OR",1718,2017,2018,287,8983000,229,6252000,58,2731000,Marion County,Marion County-Benton County-OR
349,Marion County-Deschutes County-OR-1718,"Deschutes County, OR",1718,2017,2018,246,7366000,360,12887000,-114,-5521000,Marion County,Marion County-Deschutes County-OR
350,Marion County-Los Angeles County-CA-1718,"Los Angeles County, CA",1718,2017,2018,281,5671000,106,1824000,175,3847000,Marion County,Marion County-Los Angeles County-CA
351,Marion County-Clark County-WA-1718,"Clark County, WA",1718,2017,2018,256,6722000,337,15179000,-81,-8457000,Marion County,Marion County-Clark County-WA
352,Marion County-Lincoln County-OR-1718,"Lincoln County, OR",1718,2017,2018,177,3792000,132,2896000,45,896000,Marion County,Marion County-Lincoln County-OR
353,Marion County-King County-WA-1718,"King County, WA",1718,2017,2018,146,5424000,125,4754000,21,670000,Marion County,Marion County-King County-WA
354,Marion County-San Diego County-CA-1718,"San Diego County, CA",1718,2017,2018,172,4522000,96,2658000,76,1864000,Marion County,Marion County-San Diego County-CA
355,Marion County-Maricopa County-AZ-1718,"Maricopa County, AZ",1718,2017,2018,140,5066000,220,6029000,-80,-963000,Marion County,Marion County-Maricopa County-AZ
356,Marion County-Jackson County-OR-1718,"Jackson County, OR",1718,2017,2018,138,4046000,106,2806000,32,1240000,Marion County,Marion County-Jackson County-OR
357,Marion County-Clark County-NV-1718,"Clark County, NV",1718,2017,2018,100,3435000,119,2966000,-19,469000,Marion County,Marion County-Clark County-NV
358,Marion County-Sacramento County-CA-1718,"Sacramento County, CA",1718,2017,2018,109,2284000,55,1552000,54,732000,Marion County,Marion County-Sacramento County-CA
359,Marion County-San Bernardino County-CA-1718,"San Bernardino County, CA",1718,2017,2018,108,2392000,40,648000,68,1744000,Marion County,Marion County-San Bernardino County-CA
360,Marion County-Orange County-CA-1718,"Orange County, CA",1718,2017,2018,98,2653000,43,1344000,55,1309000,Marion County,Marion County-Orange County-CA
361,Marion County-Douglas County-OR-1718,"Douglas County, OR",1718,2017,2018,86,2339000,67,2228000,19,111000,Marion County,Marion County-Douglas County-OR
362,Marion County-Riverside County-CA-1718,"Riverside County, CA",1718,2017,2018,82,2194000,82,2412000,0,-218000,Marion County,Marion County-Riverside County-CA
363,Marion County-Pierce County-WA-1718,"Pierce County, WA",1718,2017,2018,72,1798000,93,2140000,-21,-342000,Marion County,Marion County-Pierce County-WA
364,Marion County-Snohomish County-WA-1718,"Snohomish County, WA",1718,2017,2018,78,2300000,72,1796000,6,504000,Marion County,Marion County-Snohomish County-WA
365,Marion County-Umatilla County-OR-1718,"Umatilla County, OR",1718,2017,2018,79,1904000,54,1256000,25,648000,Marion County,Marion County-Umatilla County-OR
366,Marion County-Ada County-ID-1718,"Ada County, ID",1718,2017,2018,67,1757000,90,3061000,-23,-1304000,Marion County,Marion County-Ada County-ID
367,Marion County-Honolulu County-HI-1718,"Honolulu County, HI",1718,2017,2018,95,1488000,46,830000,49,658000,Marion County,Marion County-Honolulu County-HI
368,Marion County-Klamath County-OR-1718,"Klamath County, OR",1718,2017,2018,63,1326000,82,1460000,-19,-134000,Marion County,Marion County-Klamath County-OR
369,Marion County-Coos County-OR-1718,"Coos County, OR",1718,2017,2018,59,1114000,33,715000,26,399000,Marion County,Marion County-Coos County-OR
370,Marion County-Spokane County-WA-1718,"Spokane County, WA",1718,2017,2018,50,1122000,92,2243000,-42,-1121000,Marion County,Marion County-Spokane County-WA
371,Marion County-Pima County-AZ-1718,"Pima County, AZ",1718,2017,2018,54,1354000,53,2361000,1,-1007000,Marion County,Marion County-Pima County-AZ
372,Marion County-Josephine County-OR-1718,"Josephine County, OR",1718,2017,2018,57,1425000,52,1140000,5,285000,Marion County,Marion County-Josephine County-OR
373,Marion County-Tillamook County-OR-1718,"Tillamook County, OR",1718,2017,2018,51,1266000,65,1436000,-14,-170000,Marion County,Marion County-Tillamook County-OR
374,Marion County-Washoe County-NV-1718,"Washoe County, NV",1718,2017,2018,47,1779000,37,1251000,10,528000,Marion County,Marion County-Washoe County-NV
375,Marion County-Thurston County-WA-1718,"Thurston County, WA",1718,2017,2018,52,1553000,56,1234000,-4,319000,Marion County,Marion County-Thurston County-WA
377,Morrow County-Umatilla County-OR-1718,"Umatilla County, OR",1718,2017,2018,289,5241000,308,5281000,-19,-40000,Morrow County,Morrow County-Umatilla County-OR
379,Multnomah County-Washington County-OR-1718,"Washington County, OR",1718,2017,2018,6311,277260000,7216,374794000,-905,-97534000,Multnomah County,Multnomah County-Washington County-OR
380,Multnomah County-Clackamas County-OR-1718,"Clackamas County, OR",1718,2017,2018,6351,228376000,9734,351923000,-3383,-123547000,Multnomah County,Multnomah County-Clackamas County-OR
381,Multnomah County-Clark County-WA-1718,"Clark County, WA",1718,2017,2018,2939,113788000,5041,177868000,-2102,-64080000,Multnomah County,Multnomah County-Clark County-WA
382,Multnomah County-King County-WA-1718,"King County, WA",1718,2017,2018,1322,69617000,1139,65892000,183,3725000,Multnomah County,Multnomah County-King County-WA
383,Multnomah County-Los Angeles County-CA-1718,"Los Angeles County, CA",1718,2017,2018,1169,52173000,783,36094000,386,16079000,Multnomah County,Multnomah County-Los Angeles County-CA
384,Multnomah County-Lane County-OR-1718,"Lane County, OR",1718,2017,2018,847,24721000,684,21619000,163,3102000,Multnomah County,Multnomah County-Lane County-OR
385,Multnomah County-Marion County-OR-1718,"Marion County, OR",1718,2017,2018,798,22796000,974,28470000,-176,-5674000,Multnomah County,Multnomah County-Marion County-OR
386,Multnomah County-San Francisco County-CA-1718,"San Francisco County, CA",1718,2017,2018,619,58902000,274,22453000,345,36449000,Multnomah County,Multnomah County-San Francisco County-CA
387,Multnomah County-San Diego County-CA-1718,"San Diego County, CA",1718,2017,2018,607,23818000,388,17716000,219,6102000,Multnomah County,Multnomah County-San Diego County-CA
388,Multnomah County-Alameda County-CA-1718,"Alameda County, CA",1718,2017,2018,563,34292000,269,15484000,294,18808000,Multnomah County,Multnomah County-Alameda County-CA
389,Multnomah County-Maricopa County-AZ-1718,"Maricopa County, AZ",1718,2017,2018,513,22575000,543,28015000,-30,-5440000,Multnomah County,Multnomah County-Maricopa County-AZ
390,Multnomah County-Cook County-IL-1718,"Cook County, IL",1718,2017,2018,442,24435000,252,12770000,190,11665000,Multnomah County,Multnomah County-Cook County-IL
391,Multnomah County-Orange County-CA-1718,"Orange County, CA",1718,2017,2018,410,20968000,220,10426000,190,10542000,Multnomah County,Multnomah County-Orange County-CA
392,Multnomah County-Santa Clara County-CA-1718,"Santa Clara County, CA",1718,2017,2018,434,39280000,245,15599000,189,23681000,Multnomah County,Multnomah County-Santa Clara County-CA
393,Multnomah County-Kings County-NY-1718,"Kings County, NY",1718,2017,2018,353,31741000,214,14328000,139,17413000,Multnomah County,Multnomah County-Kings County-NY
394,Multnomah County-Deschutes County-OR-1718,"Deschutes County, OR",1718,2017,2018,385,17111000,732,39799000,-347,-22688000,Multnomah County,Multnomah County-Deschutes County-OR
395,Multnomah County-Benton County-OR-1718,"Benton County, OR",1718,2017,2018,317,10701000,256,7928000,61,2773000,Multnomah County,Multnomah County-Benton County-OR
396,Multnomah County-Jackson County-OR-1718,"Jackson County, OR",1718,2017,2018,311,10359000,258,9694000,53,665000,Multnomah County,Multnomah County-Jackson County-OR
397,Multnomah County-Yamhill County-OR-1718,"Yamhill County, OR",1718,2017,2018,289,10316000,344,15157000,-55,-4841000,Multnomah County,Multnomah County-Yamhill County-OR
398,Multnomah County-Columbia County-OR-1718,"Columbia County, OR",1718,2017,2018,300,14228000,638,21080000,-338,-6852000,Multnomah County,Multnomah County-Columbia County-OR
399,Multnomah County-Clark County-NV-1718,"Clark County, NV",1718,2017,2018,281,8686000,369,13737000,-88,-5051000,Multnomah County,Multnomah County-Clark County-NV
400,Multnomah County-Pierce County-WA-1718,"Pierce County, WA",1718,2017,2018,247,7479000,295,12314000,-48,-4835000,Multnomah County,Multnomah County-Pierce County-WA
401,Multnomah County-Honolulu County-HI-1718,"Honolulu County, HI",1718,2017,2018,289,9698000,128,3508000,161,6190000,Multnomah County,Multnomah County-Honolulu County-HI
402,Multnomah County-Travis County-TX-1718,"Travis County, TX",1718,2017,2018,224,9950000,185,7990000,39,1960000,Multnomah County,Multnomah County-Travis County-TX
403,Multnomah County-New York County-NY-1718,"New York County, NY",1718,2017,2018,211,20987000,170,13753000,41,7234000,Multnomah County,Multnomah County-New York County-NY
404,Multnomah County-Salt Lake County-UT-1718,"Salt Lake County, UT",1718,2017,2018,210,9593000,158,8006000,52,1587000,Multnomah County,Multnomah County-Salt Lake County-UT
405,Multnomah County-San Mateo County-CA-1718,"San Mateo County, CA",1718,2017,2018,229,19616000,87,8708000,142,10908000,Multnomah County,Multnomah County-San Mateo County-CA
406,Multnomah County-Denver County-CO-1718,"Denver County, CO",1718,2017,2018,178,9632000,222,11158000,-44,-1526000,Multnomah County,Multnomah County-Denver County-CO
407,Multnomah County-Sacramento County-CA-1718,"Sacramento County, CA",1718,2017,2018,209,6771000,170,4064000,39,2707000,Multnomah County,Multnomah County-Sacramento County-CA
408,Multnomah County-Hennepin County-MN-1718,"Hennepin County, MN",1718,2017,2018,180,10267000,158,5706000,22,4561000,Multnomah County,Multnomah County-Hennepin County-MN
409,Multnomah County-Sonoma County-CA-1718,"Sonoma County, CA",1718,2017,2018,169,6987000,71,3496000,98,3491000,Multnomah County,Multnomah County-Sonoma County-CA
410,Multnomah County-Contra Costa County-CA-1718,"Contra Costa County, CA",1718,2017,2018,183,11288000,98,5703000,85,5585000,Multnomah County,Multnomah County-Contra Costa County-CA
411,Multnomah County-Harris County-TX-1718,"Harris County, TX",1718,2017,2018,184,8912000,138,5140000,46,3772000,Multnomah County,Multnomah County-Harris County-TX
412,Multnomah County-Snohomish County-WA-1718,"Snohomish County, WA",1718,2017,2018,179,6769000,133,4475000,46,2294000,Multnomah County,Multnomah County-Snohomish County-WA
413,Multnomah County-Riverside County-CA-1718,"Riverside County, CA",1718,2017,2018,172,4641000,194,9856000,-22,-5215000,Multnomah County,Multnomah County-Riverside County-CA
414,Multnomah County-Ada County-ID-1718,"Ada County, ID",1718,2017,2018,171,4868000,273,11054000,-102,-6186000,Multnomah County,Multnomah County-Ada County-ID
415,Multnomah County-District of Columbia-DC-1718,"District of Columbia, DC",1718,2017,2018,134,12170000,82,4448000,52,7722000,Multnomah County,Multnomah County-District of Columbia-DC
416,Multnomah County-Cowlitz County-WA-1718,"Cowlitz County, WA",1718,2017,2018,165,4075000,349,9883000,-184,-5808000,Multnomah County,Multnomah County-Cowlitz County-WA
417,Multnomah County-Thurston County-WA-1718,"Thurston County, WA",1718,2017,2018,151,3997000,150,5046000,1,-1049000,Multnomah County,Multnomah County-Thurston County-WA
418,Multnomah County-Polk County-OR-1718,"Polk County, OR",1718,2017,2018,151,3829000,174,4327000,-23,-498000,Multnomah County,Multnomah County-Polk County-OR
419,Multnomah County-Middlesex County-MA-1718,"Middlesex County, MA",1718,2017,2018,141,11052000,109,5389000,32,5663000,Multnomah County,Multnomah County-Middlesex County-MA
420,Multnomah County-Hood River County-OR-1718,"Hood River County, OR",1718,2017,2018,148,4264000,222,9140000,-74,-4876000,Multnomah County,Multnomah County-Hood River County-OR
421,Multnomah County-Clatsop County-OR-1718,"Clatsop County, OR",1718,2017,2018,132,6879000,270,9223000,-138,-2344000,Multnomah County,Multnomah County-Clatsop County-OR
422,Multnomah County-Spokane County-WA-1718,"Spokane County, WA",1718,2017,2018,123,4350000,275,9452000,-152,-5102000,Multnomah County,Multnomah County-Spokane County-WA
423,Multnomah County-Pima County-AZ-1718,"Pima County, AZ",1718,2017,2018,118,5080000,169,6317000,-51,-1237000,Multnomah County,Multnomah County-Pima County-AZ
424,Multnomah County-Linn County-OR-1718,"Linn County, OR",1718,2017,2018,124,2961000,208,5919000,-84,-2958000,Multnomah County,Multnomah County-Linn County-OR
425,Multnomah County-Queens County-NY-1718,"Queens County, NY",1718,2017,2018,124,6456000,86,3413000,38,3043000,Multnomah County,Multnomah County-Queens County-NY
426,Multnomah County-Dallas County-TX-1718,"Dallas County, TX",1718,2017,2018,129,6208000,101,3112000,28,3096000,Multnomah County,Multnomah County-Dallas County-TX
427,Multnomah County-Philadelphia County-PA-1718,"Philadelphia County, PA",1718,2017,2018,113,4890000,72,3211000,41,1679000,Multnomah County,Multnomah County-Philadelphia County-PA
428,Multnomah County-Anchorage Municipality-AK-1718,"Anchorage Municipality, AK",1718,2017,2018,120,4040000,82,2437000,38,1603000,Multnomah County,Multnomah County-Anchorage Municipality-AK
429,Multnomah County-Santa Barbara County-CA-1718,"Santa Barbara County, CA",1718,2017,2018,119,5839000,49,7157000,70,-1318000,Multnomah County,Multnomah County-Santa Barbara County-CA
430,Multnomah County-San Bernardino County-CA-1718,"San Bernardino County, CA",1718,2017,2018,124,3780000,102,3186000,22,594000,Multnomah County,Multnomah County-San Bernardino County-CA
431,Multnomah County-Fulton County-GA-1718,"Fulton County, GA",1718,2017,2018,117,6255000,54,2415000,63,3840000,Multnomah County,Multnomah County-Fulton County-GA
432,Multnomah County-Washoe County-NV-1718,"Washoe County, NV",1718,2017,2018,105,4679000,73,2909000,32,1770000,Multnomah County,Multnomah County-Washoe County-NV
433,Multnomah County-Whatcom County-WA-1718,"Whatcom County, WA",1718,2017,2018,100,3564000,103,4383000,-3,-819000,Multnomah County,Multnomah County-Whatcom County-WA
434,Multnomah County-Santa Cruz County-CA-1718,"Santa Cruz County, CA",1718,2017,2018,102,4508000,51,2448000,51,2060000,Multnomah County,Multnomah County-Santa Cruz County-CA
435,Multnomah County-Suffolk County-MA-1718,"Suffolk County, MA",1718,2017,2018,99,7660000,65,3147000,34,4513000,Multnomah County,Multnomah County-Suffolk County-MA
436,Multnomah County-Dane County-WI-1718,"Dane County, WI",1718,2017,2018,96,4349000,61,2451000,35,1898000,Multnomah County,Multnomah County-Dane County-WI
437,Multnomah County-Ventura County-CA-1718,"Ventura County, CA",1718,2017,2018,102,3625000,84,4243000,18,-618000,Multnomah County,Multnomah County-Ventura County-CA
438,Multnomah County-Douglas County-OR-1718,"Douglas County, OR",1718,2017,2018,119,3465000,109,3220000,10,245000,Multnomah County,Multnomah County-Douglas County-OR
439,Multnomah County-Marin County-CA-1718,"Marin County, CA",1718,2017,2018,105,6840000,29,1226000,76,5614000,Multnomah County,Multnomah County-Marin County-CA
440,Multnomah County-Franklin County-OH-1718,"Franklin County, OH",1718,2017,2018,111,4629000,93,3285000,18,1344000,Multnomah County,Multnomah County-Franklin County-OH
441,Multnomah County-Davidson County-TN-1718,"Davidson County, TN",1718,2017,2018,95,5201000,61,2133000,34,3068000,Multnomah County,Multnomah County-Davidson County-TN
442,Multnomah County-Tillamook County-OR-1718,"Tillamook County, OR",1718,2017,2018,104,3204000,189,6535000,-85,-3331000,Multnomah County,Multnomah County-Tillamook County-OR
443,Multnomah County-Bernalillo County-NM-1718,"Bernalillo County, NM",1718,2017,2018,87,4209000,114,4373000,-27,-164000,Multnomah County,Multnomah County-Bernalillo County-NM
444,Multnomah County-Milwaukee County-WI-1718,"Milwaukee County, WI",1718,2017,2018,94,3164000,42,1282000,52,1882000,Multnomah County,Multnomah County-Milwaukee County-WI
445,Multnomah County-Boulder County-CO-1718,"Boulder County, CO",1718,2017,2018,76,2684000,69,3106000,7,-422000,Multnomah County,Multnomah County-Boulder County-CO
446,Multnomah County-San Luis Obispo County-CA-1718,"San Luis Obispo County, CA",1718,2017,2018,86,4168000,51,1650000,35,2518000,Multnomah County,Multnomah County-San Luis Obispo County-CA
447,Multnomah County-Lincoln County-OR-1718,"Lincoln County, OR",1718,2017,2018,84,4084000,192,6710000,-108,-2626000,Multnomah County,Multnomah County-Lincoln County-OR
448,Multnomah County-Humboldt County-CA-1718,"Humboldt County, CA",1718,2017,2018,71,1847000,35,1124000,36,723000,Multnomah County,Multnomah County-Humboldt County-CA
449,Multnomah County-Hawaii County-HI-1718,"Hawaii County, HI",1718,2017,2018,90,2065000,86,3092000,4,-1027000,Multnomah County,Multnomah County-Hawaii County-HI
450,Multnomah County-Josephine County-OR-1718,"Josephine County, OR",1718,2017,2018,82,2095000,57,1310000,25,785000,Multnomah County,Multnomah County-Josephine County-OR
451,Multnomah County-Wasco County-OR-1718,"Wasco County, OR",1718,2017,2018,94,2420000,127,4038000,-33,-1618000,Multnomah County,Multnomah County-Wasco County-OR
452,Multnomah County-Tarrant County-TX-1718,"Tarrant County, TX",1718,2017,2018,94,3405000,73,2372000,21,1033000,Multnomah County,Multnomah County-Tarrant County-TX
453,Multnomah County-Larimer County-CO-1718,"Larimer County, CO",1718,2017,2018,63,2487000,39,1956000,24,531000,Multnomah County,Multnomah County-Larimer County-CO
454,Multnomah County-Missoula County-MT-1718,"Missoula County, MT",1718,2017,2018,66,1345000,52,1749000,14,-404000,Multnomah County,Multnomah County-Missoula County-MT
455,Multnomah County-Washtenaw County-MI-1718,"Washtenaw County, MI",1718,2017,2018,82,3632000,44,2630000,38,1002000,Multnomah County,Multnomah County-Washtenaw County-MI
456,Multnomah County-Kitsap County-WA-1718,"Kitsap County, WA",1718,2017,2018,77,3169000,90,4641000,-13,-1472000,Multnomah County,Multnomah County-Kitsap County-WA
457,Multnomah County-Oakland County-MI-1718,"Oakland County, MI",1718,2017,2018,72,3484000,39,1309000,33,2175000,Multnomah County,Multnomah County-Oakland County-MI
458,Multnomah County-Mecklenburg County-NC-1718,"Mecklenburg County, NC",1718,2017,2018,75,5117000,63,3595000,12,1522000,Multnomah County,Multnomah County-Mecklenburg County-NC
459,Multnomah County-Umatilla County-OR-1718,"Umatilla County, OR",1718,2017,2018,81,2570000,86,1783000,-5,787000,Multnomah County,Multnomah County-Umatilla County-OR
460,Multnomah County-Orange County-FL-1718,"Orange County, FL",1718,2017,2018,61,1687000,45,1750000,16,-63000,Multnomah County,Multnomah County-Orange County-FL
461,Multnomah County-Fresno County-CA-1718,"Fresno County, CA",1718,2017,2018,85,2851000,46,1574000,39,1277000,Multnomah County,Multnomah County-Fresno County-CA
462,Multnomah County-Gallatin County-MT-1718,"Gallatin County, MT",1718,2017,2018,62,1937000,47,1369000,15,568000,Multnomah County,Multnomah County-Gallatin County-MT
463,Multnomah County-Fairfax County-VA-1718,"Fairfax County, VA",1718,2017,2018,81,3960000,26,1008000,55,2952000,Multnomah County,Multnomah County-Fairfax County-VA
464,Multnomah County-El Paso County-CO-1718,"El Paso County, CO",1718,2017,2018,65,2078000,55,1892000,10,186000,Multnomah County,Multnomah County-El Paso County-CO
465,Multnomah County-Miami-Dade County-FL-1718,"Miami-Dade County, FL",1718,2017,2018,69,2061000,57,2383000,12,-322000,Multnomah County,Multnomah County-Miami-Dade County-FL
466,Multnomah County-Allegheny County-PA-1718,"Allegheny County, PA",1718,2017,2018,58,3026000,57,2281000,1,745000,Multnomah County,Multnomah County-Allegheny County-PA
467,Multnomah County-Bexar County-TX-1718,"Bexar County, TX",1718,2017,2018,80,3133000,78,3186000,2,-53000,Multnomah County,Multnomah County-Bexar County-TX
468,Multnomah County-Arapahoe County-CO-1718,"Arapahoe County, CO",1718,2017,2018,60,1648000,71,2342000,-11,-694000,Multnomah County,Multnomah County-Arapahoe County-CO
469,Multnomah County-Klamath County-OR-1718,"Klamath County, OR",1718,2017,2018,68,2014000,73,1255000,-5,759000,Multnomah County,Multnomah County-Klamath County-OR
470,Multnomah County-Monterey County-CA-1718,"Monterey County, CA",1718,2017,2018,58,1626000,28,983000,30,643000,Multnomah County,Multnomah County-Monterey County-CA
471,Multnomah County-Orleans Parish-LA-1718,"Orleans Parish, LA",1718,2017,2018,61,2089000,38,1312000,23,777000,Multnomah County,Multnomah County-Orleans Parish-LA
472,Multnomah County-Hillsborough County-FL-1718,"Hillsborough County, FL",1718,2017,2018,55,2469000,66,1746000,-11,723000,Multnomah County,Multnomah County-Hillsborough County-FL
473,Multnomah County-Jackson County-MO-1718,"Jackson County, MO",1718,2017,2018,54,3440000,33,1591000,21,1849000,Multnomah County,Multnomah County-Jackson County-MO
474,Multnomah County-Palm Beach County-FL-1718,"Palm Beach County, FL",1718,2017,2018,46,1997000,37,1439000,9,558000,Multnomah County,Multnomah County-Palm Beach County-FL
475,Multnomah County-Kent County-MI-1718,"Kent County, MI",1718,2017,2018,52,1883000,45,1945000,7,-62000,Multnomah County,Multnomah County-Kent County-MI
476,Multnomah County-Utah County-UT-1718,"Utah County, UT",1718,2017,2018,67,1707000,48,933000,19,774000,Multnomah County,Multnomah County-Utah County-UT
477,Multnomah County-Benton County-WA-1718,"Benton County, WA",1718,2017,2018,58,1380000,79,2104000,-21,-724000,Multnomah County,Multnomah County-Benton County-WA
478,Multnomah County-Jefferson County-CO-1718,"Jefferson County, CO",1718,2017,2018,60,2974000,50,2246000,10,728000,Multnomah County,Multnomah County-Jefferson County-CO
479,Multnomah County-Broward County-FL-1718,"Broward County, FL",1718,2017,2018,56,2726000,48,1547000,8,1179000,Multnomah County,Multnomah County-Broward County-FL
480,Multnomah County-Wake County-NC-1718,"Wake County, NC",1718,2017,2018,50,2277000,32,1068000,18,1209000,Multnomah County,Multnomah County-Wake County-NC
481,Multnomah County-Hamilton County-OH-1718,"Hamilton County, OH",1718,2017,2018,56,3133000,36,2838000,20,295000,Multnomah County,Multnomah County-Hamilton County-OH
482,Multnomah County-Kern County-CA-1718,"Kern County, CA",1718,2017,2018,65,1804000,30,636000,35,1168000,Multnomah County,Multnomah County-Kern County-CA
483,Multnomah County-Baltimore city-MD-1718,"Baltimore city, MD",1718,2017,2018,50,3132000,43,2084000,7,1048000,Multnomah County,Multnomah County-Baltimore city-MD
484,Multnomah County-Pinellas County-FL-1718,"Pinellas County, FL",1718,2017,2018,44,1992000,77,2405000,-33,-413000,Multnomah County,Multnomah County-Pinellas County-FL
485,Multnomah County-DeKalb County-GA-1718,"DeKalb County, GA",1718,2017,2018,50,2375000,36,1455000,14,920000,Multnomah County,Multnomah County-DeKalb County-GA
486,Multnomah County-Marion County-IN-1718,"Marion County, IN",1718,2017,2018,36,1864000,41,1253000,-5,611000,Multnomah County,Multnomah County-Marion County-IN
487,Multnomah County-Ramsey County-MN-1718,"Ramsey County, MN",1718,2017,2018,54,2032000,40,1159000,14,873000,Multnomah County,Multnomah County-Ramsey County-MN
488,Multnomah County-Cuyahoga County-OH-1718,"Cuyahoga County, OH",1718,2017,2018,42,2043000,55,2097000,-13,-54000,Multnomah County,Multnomah County-Cuyahoga County-OH
489,Multnomah County-Maui County-HI-1718,"Maui County, HI",1718,2017,2018,48,827000,70,2931000,-22,-2104000,Multnomah County,Multnomah County-Maui County-HI
490,Multnomah County-Coos County-OR-1718,"Coos County, OR",1718,2017,2018,50,1513000,83,2570000,-33,-1057000,Multnomah County,Multnomah County-Coos County-OR
491,Multnomah County-San Joaquin County-CA-1718,"San Joaquin County, CA",1718,2017,2018,51,1272000,45,903000,6,369000,Multnomah County,Multnomah County-San Joaquin County-CA
492,Multnomah County-Santa Fe County-NM-1718,"Santa Fe County, NM",1718,2017,2018,46,2142000,60,3089000,-14,-947000,Multnomah County,Multnomah County-Santa Fe County-NM
493,Multnomah County-Collin County-TX-1718,"Collin County, TX",1718,2017,2018,31,1169000,35,1329000,-4,-160000,Multnomah County,Multnomah County-Collin County-TX
494,Multnomah County-Yakima County-WA-1718,"Yakima County, WA",1718,2017,2018,57,703000,52,1445000,5,-742000,Multnomah County,Multnomah County-Yakima County-WA
495,Multnomah County-Chittenden County-VT-1718,"Chittenden County, VT",1718,2017,2018,43,1284000,32,885000,11,399000,Multnomah County,Multnomah County-Chittenden County-VT
496,Multnomah County-Walla Walla County-WA-1718,"Walla Walla County, WA",1718,2017,2018,40,1018000,40,1784000,0,-766000,Multnomah County,Multnomah County-Walla Walla County-WA
497,Multnomah County-DuPage County-IL-1718,"DuPage County, IL",1718,2017,2018,46,1798000,37,1357000,9,441000,Multnomah County,Multnomah County-DuPage County-IL
498,Multnomah County-Wayne County-MI-1718,"Wayne County, MI",1718,2017,2018,40,1670000,42,1485000,-2,185000,Multnomah County,Multnomah County-Wayne County-MI
499,Multnomah County-Douglas County-NE-1718,"Douglas County, NE",1718,2017,2018,31,1793000,43,1705000,-12,88000,Multnomah County,Multnomah County-Douglas County-NE
500,Multnomah County-Canyon County-ID-1718,"Canyon County, ID",1718,2017,2018,44,981000,97,2620000,-53,-1639000,Multnomah County,Multnomah County-Canyon County-ID
501,Multnomah County-Cumberland County-ME-1718,"Cumberland County, ME",1718,2017,2018,36,1547000,40,2010000,-4,-463000,Multnomah County,Multnomah County-Cumberland County-ME
502,Multnomah County-Jefferson County-OR-1718,"Jefferson County, OR",1718,2017,2018,41,988000,76,2307000,-35,-1319000,Multnomah County,Multnomah County-Jefferson County-OR
503,Multnomah County-Kootenai County-ID-1718,"Kootenai County, ID",1718,2017,2018,28,569000,40,1562000,-12,-993000,Multnomah County,Multnomah County-Kootenai County-ID
504,Multnomah County-Polk County-IA-1718,"Polk County, IA",1718,2017,2018,33,1164000,47,861000,-14,303000,Multnomah County,Multnomah County-Polk County-IA
505,Multnomah County-Erie County-NY-1718,"Erie County, NY",1718,2017,2018,37,1202000,44,1908000,-7,-706000,Multnomah County,Multnomah County-Erie County-NY
506,Multnomah County-Skamania County-WA-1718,"Skamania County, WA",1718,2017,2018,35,1076000,61,3815000,-26,-2739000,Multnomah County,Multnomah County-Skamania County-WA
507,Multnomah County-Yavapai County-AZ-1718,"Yavapai County, AZ",1718,2017,2018,28,829000,26,653000,2,176000,Multnomah County,Multnomah County-Yavapai County-AZ
508,Multnomah County-Klickitat County-WA-1718,"Klickitat County, WA",1718,2017,2018,35,1744000,109,6596000,-74,-4852000,Multnomah County,Multnomah County-Klickitat County-WA
509,Multnomah County-Lewis County-WA-1718,"Lewis County, WA",1718,2017,2018,25,821000,45,1408000,-20,-587000,Multnomah County,Multnomah County-Lewis County-WA
510,Multnomah County-Adams County-CO-1718,"Adams County, CO",1718,2017,2018,31,832000,26,947000,5,-115000,Multnomah County,Multnomah County-Adams County-CO
512,Polk County-Marion County-OR-1718,"Marion County, OR",1718,2017,2018,2338,57228000,2302,62025000,36,-4797000,Polk County,Polk County-Marion County-OR
513,Polk County-Yamhill County-OR-1718,"Yamhill County, OR",1718,2017,2018,516,13377000,363,8536000,153,4841000,Polk County,Polk County-Yamhill County-OR
514,Polk County-Washington County-OR-1718,"Washington County, OR",1718,2017,2018,235,7033000,170,4466000,65,2567000,Polk County,Polk County-Washington County-OR
515,Polk County-Benton County-OR-1718,"Benton County, OR",1718,2017,2018,181,5354000,212,5128000,-31,226000,Polk County,Polk County-Benton County-OR
516,Polk County-Multnomah County-OR-1718,"Multnomah County, OR",1718,2017,2018,174,4327000,151,3829000,23,498000,Polk County,Polk County-Multnomah County-OR
517,Polk County-Linn County-OR-1718,"Linn County, OR",1718,2017,2018,173,3881000,264,7111000,-91,-3230000,Polk County,Polk County-Linn County-OR
518,Polk County-Clackamas County-OR-1718,"Clackamas County, OR",1718,2017,2018,171,5197000,171,5729000,0,-532000,Polk County,Polk County-Clackamas County-OR
519,Polk County-Lane County-OR-1718,"Lane County, OR",1718,2017,2018,116,3045000,128,2959000,-12,86000,Polk County,Polk County-Lane County-OR
520,Polk County-Lincoln County-OR-1718,"Lincoln County, OR",1718,2017,2018,106,2415000,58,1896000,48,519000,Polk County,Polk County-Lincoln County-OR
521,Polk County-Maricopa County-AZ-1718,"Maricopa County, AZ",1718,2017,2018,74,1798000,44,1316000,30,482000,Polk County,Polk County-Maricopa County-AZ
522,Polk County-Deschutes County-OR-1718,"Deschutes County, OR",1718,2017,2018,78,1771000,107,2970000,-29,-1199000,Polk County,Polk County-Deschutes County-OR
523,Polk County-King County-WA-1718,"King County, WA",1718,2017,2018,38,1394000,37,1680000,1,-286000,Polk County,Polk County-King County-WA
524,Polk County-Clark County-WA-1718,"Clark County, WA",1718,2017,2018,50,1250000,70,1983000,-20,-733000,Polk County,Polk County-Clark County-WA
527,Tillamook County-Multnomah County-OR-1718,"Multnomah County, OR",1718,2017,2018,189,6535000,104,3204000,85,3331000,Tillamook County,Tillamook County-Multnomah County-OR
528,Tillamook County-Washington County-OR-1718,"Washington County, OR",1718,2017,2018,146,4763000,121,3806000,25,957000,Tillamook County,Tillamook County-Washington County-OR
529,Tillamook County-Clackamas County-OR-1718,"Clackamas County, OR",1718,2017,2018,120,4217000,49,1431000,71,2786000,Tillamook County,Tillamook County-Clackamas County-OR
530,Tillamook County-Lincoln County-OR-1718,"Lincoln County, OR",1718,2017,2018,58,2278000,41,887000,17,1391000,Tillamook County,Tillamook County-Lincoln County-OR
531,Tillamook County-Clatsop County-OR-1718,"Clatsop County, OR",1718,2017,2018,45,973000,51,1076000,-6,-103000,Tillamook County,Tillamook County-Clatsop County-OR
532,Tillamook County-Marion County-OR-1718,"Marion County, OR",1718,2017,2018,65,1436000,51,1266000,14,170000,Tillamook County,Tillamook County-Marion County-OR
533,Tillamook County-Yamhill County-OR-1718,"Yamhill County, OR",1718,2017,2018,41,1229000,39,1140000,2,89000,Tillamook County,Tillamook County-Yamhill County-OR
535,Umatilla County-Walla Walla County-WA-1718,"Walla Walla County, WA",1718,2017,2018,286,4788000,307,6741000,-21,-1953000,Umatilla County,Umatilla County-Walla Walla County-WA
536,Umatilla County-Morrow County-OR-1718,"Morrow County, OR",1718,2017,2018,308,5281000,289,5241000,19,40000,Umatilla County,Umatilla County-Morrow County-OR
537,Umatilla County-Benton County-WA-1718,"Benton County, WA",1718,2017,2018,221,4178000,259,5739000,-38,-1561000,Umatilla County,Umatilla County-Benton County-WA
538,Umatilla County-Union County-OR-1718,"Union County, OR",1718,2017,2018,107,2163000,100,2026000,7,137000,Umatilla County,Umatilla County-Union County-OR
539,Umatilla County-Multnomah County-OR-1718,"Multnomah County, OR",1718,2017,2018,86,1783000,81,2570000,5,-787000,Umatilla County,Umatilla County-Multnomah County-OR
540,Umatilla County-Washington County-OR-1718,"Washington County, OR",1718,2017,2018,66,2160000,61,1126000,5,1034000,Umatilla County,Umatilla County-Washington County-OR
541,Umatilla County-Marion County-OR-1718,"Marion County, OR",1718,2017,2018,54,1256000,79,1904000,-25,-648000,Umatilla County,Umatilla County-Marion County-OR
542,Umatilla County-Lane County-OR-1718,"Lane County, OR",1718,2017,2018,48,1086000,50,1214000,-2,-128000,Umatilla County,Umatilla County-Lane County-OR
543,Umatilla County-Deschutes County-OR-1718,"Deschutes County, OR",1718,2017,2018,46,1478000,46,1249000,0,229000,Umatilla County,Umatilla County-Deschutes County-OR
544,Umatilla County-Spokane County-WA-1718,"Spokane County, WA",1718,2017,2018,42,807000,60,1491000,-18,-684000,Umatilla County,Umatilla County-Spokane County-WA
545,Umatilla County-King County-WA-1718,"King County, WA",1718,2017,2018,39,1417000,39,1509000,0,-92000,Umatilla County,Umatilla County-King County-WA
546,Umatilla County-Franklin County-WA-1718,"Franklin County, WA",1718,2017,2018,67,1228000,75,1637000,-8,-409000,Umatilla County,Umatilla County-Franklin County-WA
547,Umatilla County-Ada County-ID-1718,"Ada County, ID",1718,2017,2018,38,717000,37,947000,1,-230000,Umatilla County,Umatilla County-Ada County-ID
549,Union County-Umatilla County-OR-1718,"Umatilla County, OR",1718,2017,2018,100,2026000,107,2163000,-7,-137000,Union County,Union County-Umatilla County-OR
550,Union County-Baker County-OR-1718,"Baker County, OR",1718,2017,2018,95,1404000,88,1898000,7,-494000,Union County,Union County-Baker County-OR
553,Wasco County-Hood River County-OR-1718,"Hood River County, OR",1718,2017,2018,264,5885000,141,3474000,123,2411000,Wasco County,Wasco County-Hood River County-OR
554,Wasco County-Multnomah County-OR-1718,"Multnomah County, OR",1718,2017,2018,127,4038000,94,2420000,33,1618000,Wasco County,Wasco County-Multnomah County-OR
555,Wasco County-Klickitat County-WA-1718,"Klickitat County, WA",1718,2017,2018,125,3037000,183,3847000,-58,-810000,Wasco County,Wasco County-Klickitat County-WA
556,Wasco County-Clackamas County-OR-1718,"Clackamas County, OR",1718,2017,2018,49,1929000,50,915000,-1,1014000,Wasco County,Wasco County-Clackamas County-OR
557,Wasco County-Washington County-OR-1718,"Washington County, OR",1718,2017,2018,61,1597000,45,915000,16,682000,Wasco County,Wasco County-Washington County-OR
558,Wasco County-Deschutes County-OR-1718,"Deschutes County, OR",1718,2017,2018,48,2244000,41,1195000,7,1049000,Wasco County,Wasco County-Deschutes County-OR
560,Washington County-Multnomah County-OR-1718,"Multnomah County, OR",1718,2017,2018,7216,374794000,6311,277260000,905,97534000,Washington County,Washington County-Multnomah County-OR
561,Washington County-Clackamas County-OR-1718,"Clackamas County, OR",1718,2017,2018,3293,132725000,3803,168550000,-510,-35825000,Washington County,Washington County-Clackamas County-OR
562,Washington County-Clark County-WA-1718,"Clark County, WA",1718,2017,2018,1275,48988000,1907,74552000,-632,-25564000,Washington County,Washington County-Clark County-WA
563,Washington County-Yamhill County-OR-1718,"Yamhill County, OR",1718,2017,2018,1022,31855000,1713,60621000,-691,-28766000,Washington County,Washington County-Yamhill County-OR
564,Washington County-Marion County-OR-1718,"Marion County, OR",1718,2017,2018,893,25130000,1313,37109000,-420,-11979000,Washington County,Washington County-Marion County-OR
565,Washington County-Los Angeles County-CA-1718,"Los Angeles County, CA",1718,2017,2018,833,28954000,361,15395000,472,13559000,Washington County,Washington County-Los Angeles County-CA
566,Washington County-King County-WA-1718,"King County, WA",1718,2017,2018,681,33022000,781,46988000,-100,-13966000,Washington County,Washington County-King County-WA
567,Washington County-Maricopa County-AZ-1718,"Maricopa County, AZ",1718,2017,2018,626,26481000,962,44405000,-336,-17924000,Washington County,Washington County-Maricopa County-AZ
568,Washington County-Lane County-OR-1718,"Lane County, OR",1718,2017,2018,496,13580000,437,14487000,59,-907000,Washington County,Washington County-Lane County-OR
569,Washington County-Santa Clara County-CA-1718,"Santa Clara County, CA",1718,2017,2018,636,41704000,455,33413000,181,8291000,Washington County,Washington County-Santa Clara County-CA
570,Washington County-Orange County-CA-1718,"Orange County, CA",1718,2017,2018,462,22303000,171,6070000,291,16233000,Washington County,Washington County-Orange County-CA
571,Washington County-San Diego County-CA-1718,"San Diego County, CA",1718,2017,2018,408,16228000,319,13186000,89,3042000,Washington County,Washington County-San Diego County-CA
572,Washington County-Columbia County-OR-1718,"Columbia County, OR",1718,2017,2018,396,9696000,883,27582000,-487,-17886000,Washington County,Washington County-Columbia County-OR
573,Washington County-Benton County-OR-1718,"Benton County, OR",1718,2017,2018,291,6818000,138,3664000,153,3154000,Washington County,Washington County-Benton County-OR
574,Washington County-Deschutes County-OR-1718,"Deschutes County, OR",1718,2017,2018,275,9527000,583,31295000,-308,-21768000,Washington County,Washington County-Deschutes County-OR
575,Washington County-Alameda County-CA-1718,"Alameda County, CA",1718,2017,2018,289,14158000,138,6583000,151,7575000,Washington County,Washington County-Alameda County-CA
576,Washington County-Clark County-NV-1718,"Clark County, NV",1718,2017,2018,258,7245000,311,11382000,-53,-4137000,Washington County,Washington County-Clark County-NV
577,Washington County-Honolulu County-HI-1718,"Honolulu County, HI",1718,2017,2018,238,7310000,105,2750000,133,4560000,Washington County,Washington County-Honolulu County-HI
578,Washington County-Riverside County-CA-1718,"Riverside County, CA",1718,2017,2018,248,6929000,167,6426000,81,503000,Washington County,Washington County-Riverside County-CA
579,Washington County-Jackson County-OR-1718,"Jackson County, OR",1718,2017,2018,198,6401000,172,5487000,26,914000,Washington County,Washington County-Jackson County-OR
580,Washington County-Sacramento County-CA-1718,"Sacramento County, CA",1718,2017,2018,208,7088000,169,5508000,39,1580000,Washington County,Washington County-Sacramento County-CA
581,Washington County-Cook County-IL-1718,"Cook County, IL",1718,2017,2018,209,7888000,71,3071000,138,4817000,Washington County,Washington County-Cook County-IL
582,Washington County-Polk County-OR-1718,"Polk County, OR",1718,2017,2018,170,4466000,235,7033000,-65,-2567000,Washington County,Washington County-Polk County-OR
583,Washington County-Pierce County-WA-1718,"Pierce County, WA",1718,2017,2018,221,6526000,222,9400000,-1,-2874000,Washington County,Washington County-Pierce County-WA
584,Washington County-Snohomish County-WA-1718,"Snohomish County, WA",1718,2017,2018,202,8095000,232,8796000,-30,-701000,Washington County,Washington County-Snohomish County-WA
585,Washington County-Linn County-OR-1718,"Linn County, OR",1718,2017,2018,143,3817000,180,4625000,-37,-808000,Washington County,Washington County-Linn County-OR
586,Washington County-Clatsop County-OR-1718,"Clatsop County, OR",1718,2017,2018,182,6156000,207,7937000,-25,-1781000,Washington County,Washington County-Clatsop County-OR
587,Washington County-Contra Costa County-CA-1718,"Contra Costa County, CA",1718,2017,2018,164,8231000,99,5573000,65,2658000,Washington County,Washington County-Contra Costa County-CA
588,Washington County-Harris County-TX-1718,"Harris County, TX",1718,2017,2018,139,5416000,86,2528000,53,2888000,Washington County,Washington County-Harris County-TX
589,Washington County-Salt Lake County-UT-1718,"Salt Lake County, UT",1718,2017,2018,154,5247000,157,4966000,-3,281000,Washington County,Washington County-Salt Lake County-UT
590,Washington County-Lincoln County-OR-1718,"Lincoln County, OR",1718,2017,2018,117,6146000,161,6362000,-44,-216000,Washington County,Washington County-Lincoln County-OR
591,Washington County-Tillamook County-OR-1718,"Tillamook County, OR",1718,2017,2018,121,3806000,146,4763000,-25,-957000,Washington County,Washington County-Tillamook County-OR
592,Washington County-Travis County-TX-1718,"Travis County, TX",1718,2017,2018,132,8180000,195,11588000,-63,-3408000,Washington County,Washington County-Travis County-TX
593,Washington County-San Bernardino County-CA-1718,"San Bernardino County, CA",1718,2017,2018,134,3884000,86,1851000,48,2033000,Washington County,Washington County-San Bernardino County-CA
594,Washington County-Ada County-ID-1718,"Ada County, ID",1718,2017,2018,130,3418000,274,10087000,-144,-6669000,Washington County,Washington County-Ada County-ID
595,Washington County-Spokane County-WA-1718,"Spokane County, WA",1718,2017,2018,122,3305000,160,5788000,-38,-2483000,Washington County,Washington County-Spokane County-WA
596,Washington County-San Mateo County-CA-1718,"San Mateo County, CA",1718,2017,2018,129,7043000,58,4059000,71,2984000,Washington County,Washington County-San Mateo County-CA
597,Washington County-Dallas County-TX-1718,"Dallas County, TX",1718,2017,2018,118,4917000,104,4695000,14,222000,Washington County,Washington County-Dallas County-TX
598,Washington County-Pima County-AZ-1718,"Pima County, AZ",1718,2017,2018,116,3362000,105,6506000,11,-3144000,Washington County,Washington County-Pima County-AZ
599,Washington County-Thurston County-WA-1718,"Thurston County, WA",1718,2017,2018,96,3641000,108,2817000,-12,824000,Washington County,Washington County-Thurston County-WA
600,Washington County-Bexar County-TX-1718,"Bexar County, TX",1718,2017,2018,115,4847000,75,2404000,40,2443000,Washington County,Washington County-Bexar County-TX
601,Washington County-Ventura County-CA-1718,"Ventura County, CA",1718,2017,2018,100,2537000,49,1999000,51,538000,Washington County,Washington County-Ventura County-CA
602,Washington County-Hennepin County-MN-1718,"Hennepin County, MN",1718,2017,2018,88,3562000,73,3654000,15,-92000,Washington County,Washington County-Hennepin County-MN
603,Washington County-Cowlitz County-WA-1718,"Cowlitz County, WA",1718,2017,2018,108,2435000,138,6389000,-30,-3954000,Washington County,Washington County-Cowlitz County-WA
604,Washington County-Klamath County-OR-1718,"Klamath County, OR",1718,2017,2018,88,2327000,46,1116000,42,1211000,Washington County,Washington County-Klamath County-OR
605,Washington County-Anchorage Municipality-AK-1718,"Anchorage Municipality, AK",1718,2017,2018,89,3779000,56,2189000,33,1590000,Washington County,Washington County-Anchorage Municipality-AK
606,Washington County-San Francisco County-CA-1718,"San Francisco County, CA",1718,2017,2018,81,5779000,68,4610000,13,1169000,Washington County,Washington County-San Francisco County-CA
607,Washington County-Sonoma County-CA-1718,"Sonoma County, CA",1718,2017,2018,77,2981000,31,868000,46,2113000,Washington County,Washington County-Sonoma County-CA
608,Washington County-Kings County-NY-1718,"Kings County, NY",1718,2017,2018,67,3814000,25,830000,42,2984000,Washington County,Washington County-Kings County-NY
609,Washington County-Utah County-UT-1718,"Utah County, UT",1718,2017,2018,111,2740000,121,4501000,-10,-1761000,Washington County,Washington County-Utah County-UT
610,Washington County-Kitsap County-WA-1718,"Kitsap County, WA",1718,2017,2018,75,2351000,90,3490000,-15,-1139000,Washington County,Washington County-Kitsap County-WA
611,Washington County-Washoe County-NV-1718,"Washoe County, NV",1718,2017,2018,70,2341000,53,2147000,17,194000,Washington County,Washington County-Washoe County-NV
612,Washington County-Douglas County-OR-1718,"Douglas County, OR",1718,2017,2018,77,1946000,81,2575000,-4,-629000,Washington County,Washington County-Douglas County-OR
613,Washington County-Tarrant County-TX-1718,"Tarrant County, TX",1718,2017,2018,71,2408000,58,2428000,13,-20000,Washington County,Washington County-Tarrant County-TX
614,Washington County-Jefferson County-CO-1718,"Jefferson County, CO",1718,2017,2018,65,2497000,48,1916000,17,581000,Washington County,Washington County-Jefferson County-CO
615,Washington County-Middlesex County-MA-1718,"Middlesex County, MA",1718,2017,2018,70,4896000,54,3910000,16,986000,Washington County,Washington County-Middlesex County-MA
616,Washington County-Franklin County-OH-1718,"Franklin County, OH",1718,2017,2018,58,2392000,50,1736000,8,656000,Washington County,Washington County-Franklin County-OH
617,Washington County-Wake County-NC-1718,"Wake County, NC",1718,2017,2018,66,2982000,44,2720000,22,262000,Washington County,Washington County-Wake County-NC
618,Washington County-Mecklenburg County-NC-1718,"Mecklenburg County, NC",1718,2017,2018,74,3038000,47,1826000,27,1212000,Washington County,Washington County-Mecklenburg County-NC
619,Washington County-Larimer County-CO-1718,"Larimer County, CO",1718,2017,2018,69,2956000,34,1544000,35,1412000,Washington County,Washington County-Larimer County-CO
620,Washington County-Bernalillo County-NM-1718,"Bernalillo County, NM",1718,2017,2018,60,2248000,77,2426000,-17,-178000,Washington County,Washington County-Bernalillo County-NM
621,Washington County-Maui County-HI-1718,"Maui County, HI",1718,2017,2018,76,2626000,47,1368000,29,1258000,Washington County,Washington County-Maui County-HI
622,Washington County-Collin County-TX-1718,"Collin County, TX",1718,2017,2018,86,4265000,105,4549000,-19,-284000,Washington County,Washington County-Collin County-TX
623,Washington County-Denver County-CO-1718,"Denver County, CO",1718,2017,2018,48,1781000,51,3260000,-3,-1479000,Washington County,Washington County-Denver County-CO
624,Washington County-New York County-NY-1718,"New York County, NY",1718,2017,2018,49,2938000,31,2570000,18,368000,Washington County,Washington County-New York County-NY
625,Washington County-Coos County-OR-1718,"Coos County, OR",1718,2017,2018,61,1864000,54,1611000,7,253000,Washington County,Washington County-Coos County-OR
626,Washington County-Benton County-WA-1718,"Benton County, WA",1718,2017,2018,49,1750000,71,2611000,-22,-861000,Washington County,Washington County-Benton County-WA
627,Washington County-Arapahoe County-CO-1718,"Arapahoe County, CO",1718,2017,2018,62,1903000,89,2945000,-27,-1042000,Washington County,Washington County-Arapahoe County-CO
628,Washington County-Josephine County-OR-1718,"Josephine County, OR",1718,2017,2018,47,1042000,58,1410000,-11,-368000,Washington County,Washington County-Josephine County-OR
629,Washington County-Fulton County-GA-1718,"Fulton County, GA",1718,2017,2018,45,2575000,52,1977000,-7,598000,Washington County,Washington County-Fulton County-GA
630,Washington County-Yakima County-WA-1718,"Yakima County, WA",1718,2017,2018,49,1194000,43,804000,6,390000,Washington County,Washington County-Yakima County-WA
631,Washington County-Umatilla County-OR-1718,"Umatilla County, OR",1718,2017,2018,61,1126000,66,2160000,-5,-1034000,Washington County,Washington County-Umatilla County-OR
632,Washington County-Hillsborough County-FL-1718,"Hillsborough County, FL",1718,2017,2018,41,1250000,69,2392000,-28,-1142000,Washington County,Washington County-Hillsborough County-FL
633,Washington County-El Paso County-CO-1718,"El Paso County, CO",1718,2017,2018,54,1670000,64,1926000,-10,-256000,Washington County,Washington County-El Paso County-CO
634,Washington County-Placer County-CA-1718,"Placer County, CA",1718,2017,2018,42,1940000,44,2502000,-2,-562000,Washington County,Washington County-Placer County-CA
635,Washington County-Hood River County-OR-1718,"Hood River County, OR",1718,2017,2018,48,843000,57,3010000,-9,-2167000,Washington County,Washington County-Hood River County-OR
636,Washington County-Kootenai County-ID-1718,"Kootenai County, ID",1718,2017,2018,45,1069000,72,2491000,-27,-1422000,Washington County,Washington County-Kootenai County-ID
637,Washington County-Oakland County-MI-1718,"Oakland County, MI",1718,2017,2018,51,2231000,41,1694000,10,537000,Washington County,Washington County-Oakland County-MI
638,Washington County-San Luis Obispo County-CA-1718,"San Luis Obispo County, CA",1718,2017,2018,44,1551000,33,1147000,11,404000,Washington County,Washington County-San Luis Obispo County-CA
639,Washington County-Hawaii County-HI-1718,"Hawaii County, HI",1718,2017,2018,39,935000,36,1032000,3,-97000,Washington County,Washington County-Hawaii County-HI
640,Washington County-Wasco County-OR-1718,"Wasco County, OR",1718,2017,2018,45,915000,61,1597000,-16,-682000,Washington County,Washington County-Wasco County-OR
641,Washington County-Williamson County-TX-1718,"Williamson County, TX",1718,2017,2018,49,1508000,91,4143000,-42,-2635000,Washington County,Washington County-Williamson County-TX
642,Washington County-Palm Beach County-FL-1718,"Palm Beach County, FL",1718,2017,2018,34,1309000,35,818000,-1,491000,Washington County,Washington County-Palm Beach County-FL
643,Washington County-Canyon County-ID-1718,"Canyon County, ID",1718,2017,2018,40,1019000,106,3191000,-66,-2172000,Washington County,Washington County-Canyon County-ID
644,Washington County-Pinal County-AZ-1718,"Pinal County, AZ",1718,2017,2018,49,1333000,85,2974000,-36,-1641000,Washington County,Washington County-Pinal County-AZ
645,Washington County-Shasta County-CA-1718,"Shasta County, CA",1718,2017,2018,25,776000,33,736000,-8,40000,Washington County,Washington County-Shasta County-CA
648,Yamhill County-Washington County-OR-1718,"Washington County, OR",1718,2017,2018,1713,60621000,1022,31855000,691,28766000,Yamhill County,Yamhill County-Washington County-OR
649,Yamhill County-Clackamas County-OR-1718,"Clackamas County, OR",1718,2017,2018,476,16555000,342,12515000,134,4040000,Yamhill County,Yamhill County-Clackamas County-OR
650,Yamhill County-Multnomah County-OR-1718,"Multnomah County, OR",1718,2017,2018,344,15157000,289,10316000,55,4841000,Yamhill County,Yamhill County-Multnomah County-OR
651,Yamhill County-Marion County-OR-1718,"Marion County, OR",1718,2017,2018,446,10129000,458,11891000,-12,-1762000,Yamhill County,Yamhill County-Marion County-OR
652,Yamhill County-Polk County-OR-1718,"Polk County, OR",1718,2017,2018,363,8536000,516,13377000,-153,-4841000,Yamhill County,Yamhill County-Polk County-OR
653,Yamhill County-Deschutes County-OR-1718,"Deschutes County, OR",1718,2017,2018,95,2167000,133,5397000,-38,-3230000,Yamhill County,Yamhill County-Deschutes County-OR
654,Yamhill County-Lane County-OR-1718,"Lane County, OR",1718,2017,2018,96,2538000,79,2001000,17,537000,Yamhill County,Yamhill County-Lane County-OR
655,Yamhill County-Clark County-WA-1718,"Clark County, WA",1718,2017,2018,96,2647000,96,3599000,0,-952000,Yamhill County,Yamhill County-Clark County-WA
656,Yamhill County-King County-WA-1718,"King County, WA",1718,2017,2018,73,4606000,46,2607000,27,1999000,Yamhill County,Yamhill County-King County-WA
657,Yamhill County-Lincoln County-OR-1718,"Lincoln County, OR",1718,2017,2018,57,1365000,77,2137000,-20,-772000,Yamhill County,Yamhill County-Lincoln County-OR
658,Yamhill County-Benton County-OR-1718,"Benton County, OR",1718,2017,2018,52,2706000,37,1033000,15,1673000,Yamhill County,Yamhill County-Benton County-OR
659,Yamhill County-Maricopa County-AZ-1718,"Maricopa County, AZ",1718,2017,2018,54,1048000,45,1174000,9,-126000,Yamhill County,Yamhill County-Maricopa County-AZ
660,Yamhill County-Linn County-OR-1718,"Linn County, OR",1718,2017,2018,41,966000,70,2219000,-29,-1253000,Yamhill County,Yamhill County-Linn County-OR
661,Yamhill County-Tillamook County-OR-1718,"Tillamook County, OR",1718,2017,2018,39,1140000,41,1229000,-2,-89000,Yamhill County,Yamhill County-Tillamook County-OR
663,Baker County-Union County-OR-1617,"Union County, OR",1617,2016,2017,108,2374000,99,1466000,9,908000,Baker County,Baker County-Union County-OR
664,Baker County-Ada County-ID-1617,"Ada County, ID",1617,2016,2017,74,1626000,69,1600000,5,26000,Baker County,Baker County-Ada County-ID
666,Benton County-Linn County-OR-1617,"Linn County, OR",1617,2016,2017,1290,31987000,1750,47008000,-460,-15021000,Benton County,Benton County-Linn County-OR
667,Benton County-Lane County-OR-1617,"Lane County, OR",1617,2016,2017,404,10115000,462,12352000,-58,-2237000,Benton County,Benton County-Lane County-OR
668,Benton County-Multnomah County-OR-1617,"Multnomah County, OR",1617,2016,2017,342,10530000,463,13932000,-121,-3402000,Benton County,Benton County-Multnomah County-OR
669,Benton County-Marion County-OR-1617,"Marion County, OR",1617,2016,2017,335,8475000,415,12996000,-80,-4521000,Benton County,Benton County-Marion County-OR
670,Benton County-Washington County-OR-1617,"Washington County, OR",1617,2016,2017,243,6925000,436,12159000,-193,-5234000,Benton County,Benton County-Washington County-OR
671,Benton County-Clackamas County-OR-1617,"Clackamas County, OR",1617,2016,2017,165,4495000,181,6725000,-16,-2230000,Benton County,Benton County-Clackamas County-OR
672,Benton County-Lincoln County-OR-1617,"Lincoln County, OR",1617,2016,2017,187,5247000,130,3520000,57,1727000,Benton County,Benton County-Lincoln County-OR
673,Benton County-Polk County-OR-1617,"Polk County, OR",1617,2016,2017,142,3666000,212,6008000,-70,-2342000,Benton County,Benton County-Polk County-OR
674,Benton County-Deschutes County-OR-1617,"Deschutes County, OR",1617,2016,2017,128,2952000,255,8831000,-127,-5879000,Benton County,Benton County-Deschutes County-OR
675,Benton County-King County-WA-1617,"King County, WA",1617,2016,2017,131,5765000,123,7350000,8,-1585000,Benton County,Benton County-King County-WA
676,Benton County-Los Angeles County-CA-1617,"Los Angeles County, CA",1617,2016,2017,113,3571000,80,2343000,33,1228000,Benton County,Benton County-Los Angeles County-CA
677,Benton County-San Diego County-CA-1617,"San Diego County, CA",1617,2016,2017,106,3293000,42,1602000,64,1691000,Benton County,Benton County-San Diego County-CA
678,Benton County-Jackson County-OR-1617,"Jackson County, OR",1617,2016,2017,63,1394000,93,2743000,-30,-1349000,Benton County,Benton County-Jackson County-OR
679,Benton County-Maricopa County-AZ-1617,"Maricopa County, AZ",1617,2016,2017,75,2388000,72,2110000,3,278000,Benton County,Benton County-Maricopa County-AZ
680,Benton County-Yamhill County-OR-1617,"Yamhill County, OR",1617,2016,2017,58,1873000,62,1629000,-4,244000,Benton County,Benton County-Yamhill County-OR
681,Benton County-Douglas County-OR-1617,"Douglas County, OR",1617,2016,2017,58,1261000,57,1822000,1,-561000,Benton County,Benton County-Douglas County-OR
682,Benton County-Santa Clara County-CA-1617,"Santa Clara County, CA",1617,2016,2017,52,4780000,53,2867000,-1,1913000,Benton County,Benton County-Santa Clara County-CA
683,Benton County-Ada County-ID-1617,"Ada County, ID",1617,2016,2017,59,1761000,31,869000,28,892000,Benton County,Benton County-Ada County-ID
684,Benton County-Clark County-WA-1617,"Clark County, WA",1617,2016,2017,49,1512000,98,3092000,-49,-1580000,Benton County,Benton County-Clark County-WA
685,Benton County-Coos County-OR-1617,"Coos County, OR",1617,2016,2017,41,1067000,36,1184000,5,-117000,Benton County,Benton County-Coos County-OR
686,Benton County-Pierce County-WA-1617,"Pierce County, WA",1617,2016,2017,46,1249000,54,1424000,-8,-175000,Benton County,Benton County-Pierce County-WA
687,Benton County-Sacramento County-CA-1617,"Sacramento County, CA",1617,2016,2017,37,992000,32,720000,5,272000,Benton County,Benton County-Sacramento County-CA
689,Clackamas County-Multnomah County-OR-1617,"Multnomah County, OR",1617,2016,2017,13814,520879000,7811,276742000,6003,244137000,Clackamas County,Clackamas County-Multnomah County-OR
690,Clackamas County-Washington County-OR-1617,"Washington County, OR",1617,2016,2017,5698,247004000,4385,181440000,1313,65564000,Clackamas County,Clackamas County-Washington County-OR
691,Clackamas County-Marion County-OR-1617,"Marion County, OR",1617,2016,2017,1531,44951000,2554,70252000,-1023,-25301000,Clackamas County,Clackamas County-Marion County-OR
692,Clackamas County-Clark County-WA-1617,"Clark County, WA",1617,2016,2017,1334,53071000,2257,87378000,-923,-34307000,Clackamas County,Clackamas County-Clark County-WA
693,Clackamas County-Los Angeles County-CA-1617,"Los Angeles County, CA",1617,2016,2017,681,32963000,216,9901000,465,23062000,Clackamas County,Clackamas County-Los Angeles County-CA
694,Clackamas County-Lane County-OR-1617,"Lane County, OR",1617,2016,2017,425,14292000,379,12078000,46,2214000,Clackamas County,Clackamas County-Lane County-OR
695,Clackamas County-King County-WA-1617,"King County, WA",1617,2016,2017,486,25073000,389,20636000,97,4437000,Clackamas County,Clackamas County-King County-WA
696,Clackamas County-Yamhill County-OR-1617,"Yamhill County, OR",1617,2016,2017,427,18545000,599,20064000,-172,-1519000,Clackamas County,Clackamas County-Yamhill County-OR
697,Clackamas County-Maricopa County-AZ-1617,"Maricopa County, AZ",1617,2016,2017,377,24634000,468,26227000,-91,-1593000,Clackamas County,Clackamas County-Maricopa County-AZ
698,Clackamas County-Deschutes County-OR-1617,"Deschutes County, OR",1617,2016,2017,338,10356000,891,40337000,-553,-29981000,Clackamas County,Clackamas County-Deschutes County-OR
699,Clackamas County-San Diego County-CA-1617,"San Diego County, CA",1617,2016,2017,417,15944000,197,9029000,220,6915000,Clackamas County,Clackamas County-San Diego County-CA
700,Clackamas County-Orange County-CA-1617,"Orange County, CA",1617,2016,2017,332,14383000,108,6123000,224,8260000,Clackamas County,Clackamas County-Orange County-CA
701,Clackamas County-Santa Clara County-CA-1617,"Santa Clara County, CA",1617,2016,2017,328,30505000,76,5516000,252,24989000,Clackamas County,Clackamas County-Santa Clara County-CA
702,Clackamas County-Benton County-OR-1617,"Benton County, OR",1617,2016,2017,181,6725000,165,4495000,16,2230000,Clackamas County,Clackamas County-Benton County-OR
703,Clackamas County-Alameda County-CA-1617,"Alameda County, CA",1617,2016,2017,244,13267000,64,3612000,180,9655000,Clackamas County,Clackamas County-Alameda County-CA
704,Clackamas County-Polk County-OR-1617,"Polk County, OR",1617,2016,2017,178,5069000,280,7636000,-102,-2567000,Clackamas County,Clackamas County-Polk County-OR
705,Clackamas County-Linn County-OR-1617,"Linn County, OR",1617,2016,2017,173,5656000,258,6532000,-85,-876000,Clackamas County,Clackamas County-Linn County-OR
706,Clackamas County-Contra Costa County-CA-1617,"Contra Costa County, CA",1617,2016,2017,204,12183000,68,2877000,136,9306000,Clackamas County,Clackamas County-Contra Costa County-CA
707,Clackamas County-Jackson County-OR-1617,"Jackson County, OR",1617,2016,2017,154,6206000,187,5540000,-33,666000,Clackamas County,Clackamas County-Jackson County-OR
708,Clackamas County-Pierce County-WA-1617,"Pierce County, WA",1617,2016,2017,194,5750000,237,9532000,-43,-3782000,Clackamas County,Clackamas County-Pierce County-WA
709,Clackamas County-Clark County-NV-1617,"Clark County, NV",1617,2016,2017,173,6657000,190,7509000,-17,-852000,Clackamas County,Clackamas County-Clark County-NV
710,Clackamas County-Honolulu County-HI-1617,"Honolulu County, HI",1617,2016,2017,178,8879000,76,2911000,102,5968000,Clackamas County,Clackamas County-Honolulu County-HI
711,Clackamas County-Ada County-ID-1617,"Ada County, ID",1617,2016,2017,150,5515000,239,8712000,-89,-3197000,Clackamas County,Clackamas County-Ada County-ID
712,Clackamas County-Riverside County-CA-1617,"Riverside County, CA",1617,2016,2017,161,6507000,111,4247000,50,2260000,Clackamas County,Clackamas County-Riverside County-CA
713,Clackamas County-Snohomish County-WA-1617,"Snohomish County, WA",1617,2016,2017,168,5677000,118,4240000,50,1437000,Clackamas County,Clackamas County-Snohomish County-WA
714,Clackamas County-Clatsop County-OR-1617,"Clatsop County, OR",1617,2016,2017,138,3861000,158,5106000,-20,-1245000,Clackamas County,Clackamas County-Clatsop County-OR
715,Clackamas County-Salt Lake County-UT-1617,"Salt Lake County, UT",1617,2016,2017,114,3562000,77,2485000,37,1077000,Clackamas County,Clackamas County-Salt Lake County-UT
716,Clackamas County-Columbia County-OR-1617,"Columbia County, OR",1617,2016,2017,106,3180000,229,7588000,-123,-4408000,Clackamas County,Clackamas County-Columbia County-OR
717,Clackamas County-Sacramento County-CA-1617,"Sacramento County, CA",1617,2016,2017,104,4196000,68,2336000,36,1860000,Clackamas County,Clackamas County-Sacramento County-CA
718,Clackamas County-San Bernardino County-CA-1617,"San Bernardino County, CA",1617,2016,2017,134,3840000,57,1619000,77,2221000,Clackamas County,Clackamas County-San Bernardino County-CA
719,Clackamas County-Lincoln County-OR-1617,"Lincoln County, OR",1617,2016,2017,92,3903000,152,7087000,-60,-3184000,Clackamas County,Clackamas County-Lincoln County-OR
720,Clackamas County-Spokane County-WA-1617,"Spokane County, WA",1617,2016,2017,105,4082000,137,3673000,-32,409000,Clackamas County,Clackamas County-Spokane County-WA
721,Clackamas County-San Francisco County-CA-1617,"San Francisco County, CA",1617,2016,2017,89,7508000,32,2262000,57,5246000,Clackamas County,Clackamas County-San Francisco County-CA
722,Clackamas County-Douglas County-OR-1617,"Douglas County, OR",1617,2016,2017,100,2928000,94,2581000,6,347000,Clackamas County,Clackamas County-Douglas County-OR
723,Clackamas County-Cowlitz County-WA-1617,"Cowlitz County, WA",1617,2016,2017,97,1967000,167,4837000,-70,-2870000,Clackamas County,Clackamas County-Cowlitz County-WA
724,Clackamas County-Pima County-AZ-1617,"Pima County, AZ",1617,2016,2017,74,2402000,112,7126000,-38,-4724000,Clackamas County,Clackamas County-Pima County-AZ
725,Clackamas County-Washoe County-NV-1617,"Washoe County, NV",1617,2016,2017,78,2489000,62,1673000,16,816000,Clackamas County,Clackamas County-Washoe County-NV
726,Clackamas County-Cook County-IL-1617,"Cook County, IL",1617,2016,2017,81,5767000,49,2066000,32,3701000,Clackamas County,Clackamas County-Cook County-IL
727,Clackamas County-Umatilla County-OR-1617,"Umatilla County, OR",1617,2016,2017,73,2318000,79,1639000,-6,679000,Clackamas County,Clackamas County-Umatilla County-OR
728,Clackamas County-Thurston County-WA-1617,"Thurston County, WA",1617,2016,2017,82,2871000,105,3891000,-23,-1020000,Clackamas County,Clackamas County-Thurston County-WA
729,Clackamas County-Josephine County-OR-1617,"Josephine County, OR",1617,2016,2017,59,1299000,90,2296000,-31,-997000,Clackamas County,Clackamas County-Josephine County-OR
730,Clackamas County-Tillamook County-OR-1617,"Tillamook County, OR",1617,2016,2017,62,2337000,126,5250000,-64,-2913000,Clackamas County,Clackamas County-Tillamook County-OR
731,Clackamas County-Wasco County-OR-1617,"Wasco County, OR",1617,2016,2017,68,1559000,82,2395000,-14,-836000,Clackamas County,Clackamas County-Wasco County-OR
732,Clackamas County-Coos County-OR-1617,"Coos County, OR",1617,2016,2017,58,1721000,72,1606000,-14,115000,Clackamas County,Clackamas County-Coos County-OR
733,Clackamas County-Klamath County-OR-1617,"Klamath County, OR",1617,2016,2017,63,1437000,83,3990000,-20,-2553000,Clackamas County,Clackamas County-Klamath County-OR
734,Clackamas County-Kitsap County-WA-1617,"Kitsap County, WA",1617,2016,2017,58,2035000,58,1532000,0,503000,Clackamas County,Clackamas County-Kitsap County-WA
735,Clackamas County-Utah County-UT-1617,"Utah County, UT",1617,2016,2017,85,1830000,70,1481000,15,349000,Clackamas County,Clackamas County-Utah County-UT
736,Clackamas County-Jefferson County-OR-1617,"Jefferson County, OR",1617,2016,2017,59,3297000,92,3039000,-33,258000,Clackamas County,Clackamas County-Jefferson County-OR
737,Clackamas County-Travis County-TX-1617,"Travis County, TX",1617,2016,2017,50,2455000,62,5738000,-12,-3283000,Clackamas County,Clackamas County-Travis County-TX
738,Clackamas County-Arapahoe County-CO-1617,"Arapahoe County, CO",1617,2016,2017,67,2394000,39,1408000,28,986000,Clackamas County,Clackamas County-Arapahoe County-CO
739,Clackamas County-Anchorage Municipality-AK-1617,"Anchorage Municipality, AK",1617,2016,2017,59,1857000,35,1673000,24,184000,Clackamas County,Clackamas County-Anchorage Municipality-AK
740,Clackamas County-El Paso County-CO-1617,"El Paso County, CO",1617,2016,2017,54,1649000,63,1615000,-9,34000,Clackamas County,Clackamas County-El Paso County-CO
741,Clackamas County-Hood River County-OR-1617,"Hood River County, OR",1617,2016,2017,47,981000,63,1956000,-16,-975000,Clackamas County,Clackamas County-Hood River County-OR
742,Clackamas County-Dallas County-TX-1617,"Dallas County, TX",1617,2016,2017,42,2026000,45,1600000,-3,426000,Clackamas County,Clackamas County-Dallas County-TX
743,Clackamas County-Denver County-CO-1617,"Denver County, CO",1617,2016,2017,37,1481000,51,1325000,-14,156000,Clackamas County,Clackamas County-Denver County-CO
744,Clackamas County-Bexar County-TX-1617,"Bexar County, TX",1617,2016,2017,60,2422000,43,1415000,17,1007000,Clackamas County,Clackamas County-Bexar County-TX
745,Clackamas County-Crook County-OR-1617,"Crook County, OR",1617,2016,2017,38,984000,167,7989000,-129,-7005000,Clackamas County,Clackamas County-Crook County-OR
746,Clackamas County-Tarrant County-TX-1617,"Tarrant County, TX",1617,2016,2017,37,1945000,35,935000,2,1010000,Clackamas County,Clackamas County-Tarrant County-TX
747,Clackamas County-Placer County-CA-1617,"Placer County, CA",1617,2016,2017,42,1862000,43,2429000,-1,-567000,Clackamas County,Clackamas County-Placer County-CA
748,Clackamas County-Benton County-WA-1617,"Benton County, WA",1617,2016,2017,47,2320000,81,2708000,-34,-388000,Clackamas County,Clackamas County-Benton County-WA
750,Clatsop County-Multnomah County-OR-1617,"Multnomah County, OR",1617,2016,2017,346,11752000,141,4290000,205,7462000,Clatsop County,Clatsop County-Multnomah County-OR
751,Clatsop County-Washington County-OR-1617,"Washington County, OR",1617,2016,2017,303,11672000,192,4739000,111,6933000,Clatsop County,Clatsop County-Washington County-OR
752,Clatsop County-Clackamas County-OR-1617,"Clackamas County, OR",1617,2016,2017,158,5106000,138,3861000,20,1245000,Clatsop County,Clatsop County-Clackamas County-OR
753,Clatsop County-King County-WA-1617,"King County, WA",1617,2016,2017,85,3054000,41,1252000,44,1802000,Clatsop County,Clatsop County-King County-WA
754,Clatsop County-Columbia County-OR-1617,"Columbia County, OR",1617,2016,2017,99,2154000,97,1515000,2,639000,Clatsop County,Clatsop County-Columbia County-OR
755,Clatsop County-Tillamook County-OR-1617,"Tillamook County, OR",1617,2016,2017,78,2019000,83,1414000,-5,605000,Clatsop County,Clatsop County-Tillamook County-OR
756,Clatsop County-Pacific County-WA-1617,"Pacific County, WA",1617,2016,2017,107,1638000,157,3379000,-50,-1741000,Clatsop County,Clatsop County-Pacific County-WA
757,Clatsop County-Clark County-WA-1617,"Clark County, WA",1617,2016,2017,72,2579000,77,3140000,-5,-561000,Clatsop County,Clatsop County-Clark County-WA
758,Clatsop County-Deschutes County-OR-1617,"Deschutes County, OR",1617,2016,2017,70,1787000,86,3021000,-16,-1234000,Clatsop County,Clatsop County-Deschutes County-OR
759,Clatsop County-Marion County-OR-1617,"Marion County, OR",1617,2016,2017,61,1718000,56,1322000,5,396000,Clatsop County,Clatsop County-Marion County-OR
760,Clatsop County-Lane County-OR-1617,"Lane County, OR",1617,2016,2017,67,1074000,46,1196000,21,-122000,Clatsop County,Clatsop County-Lane County-OR
761,Clatsop County-Cowlitz County-WA-1617,"Cowlitz County, WA",1617,2016,2017,81,2356000,61,1527000,20,829000,Clatsop County,Clatsop County-Cowlitz County-WA
762,Clatsop County-Pierce County-WA-1617,"Pierce County, WA",1617,2016,2017,48,1409000,38,990000,10,419000,Clatsop County,Clatsop County-Pierce County-WA
764,Columbia County-Washington County-OR-1617,"Washington County, OR",1617,2016,2017,1280,39843000,477,13267000,803,26576000,Columbia County,Columbia County-Washington County-OR
765,Columbia County-Multnomah County-OR-1617,"Multnomah County, OR",1617,2016,2017,980,30573000,290,8997000,690,21576000,Columbia County,Columbia County-Multnomah County-OR
766,Columbia County-Clackamas County-OR-1617,"Clackamas County, OR",1617,2016,2017,229,7588000,106,3180000,123,4408000,Columbia County,Columbia County-Clackamas County-OR
767,Columbia County-Cowlitz County-WA-1617,"Cowlitz County, WA",1617,2016,2017,182,3094000,286,7274000,-104,-4180000,Columbia County,Columbia County-Cowlitz County-WA
768,Columbia County-Clark County-WA-1617,"Clark County, WA",1617,2016,2017,148,4076000,175,7457000,-27,-3381000,Columbia County,Columbia County-Clark County-WA
769,Columbia County-Clatsop County-OR-1617,"Clatsop County, OR",1617,2016,2017,97,1515000,99,2154000,-2,-639000,Columbia County,Columbia County-Clatsop County-OR
770,Columbia County-Marion County-OR-1617,"Marion County, OR",1617,2016,2017,66,1341000,69,1893000,-3,-552000,Columbia County,Columbia County-Marion County-OR
771,Columbia County-Yamhill County-OR-1617,"Yamhill County, OR",1617,2016,2017,53,1378000,68,1921000,-15,-543000,Columbia County,Columbia County-Yamhill County-OR
773,Coos County-Lane County-OR-1617,"Lane County, OR",1617,2016,2017,257,5606000,353,8198000,-96,-2592000,Coos County,Coos County-Lane County-OR
774,Coos County-Douglas County-OR-1617,"Douglas County, OR",1617,2016,2017,259,4867000,256,6414000,3,-1547000,Coos County,Coos County-Douglas County-OR
775,Coos County-Jackson County-OR-1617,"Jackson County, OR",1617,2016,2017,146,3185000,115,2699000,31,486000,Coos County,Coos County-Jackson County-OR
776,Coos County-Multnomah County-OR-1617,"Multnomah County, OR",1617,2016,2017,117,2794000,58,1457000,59,1337000,Coos County,Coos County-Multnomah County-OR
777,Coos County-Curry County-OR-1617,"Curry County, OR",1617,2016,2017,110,3056000,81,1437000,29,1619000,Coos County,Coos County-Curry County-OR
778,Coos County-Washington County-OR-1617,"Washington County, OR",1617,2016,2017,75,3142000,61,2219000,14,923000,Coos County,Coos County-Washington County-OR
779,Coos County-Clackamas County-OR-1617,"Clackamas County, OR",1617,2016,2017,72,1606000,58,1721000,14,-115000,Coos County,Coos County-Clackamas County-OR
780,Coos County-Deschutes County-OR-1617,"Deschutes County, OR",1617,2016,2017,74,1189000,75,1938000,-1,-749000,Coos County,Coos County-Deschutes County-OR
781,Coos County-Josephine County-OR-1617,"Josephine County, OR",1617,2016,2017,66,3201000,41,935000,25,2266000,Coos County,Coos County-Josephine County-OR
782,Coos County-Linn County-OR-1617,"Linn County, OR",1617,2016,2017,83,1607000,85,1692000,-2,-85000,Coos County,Coos County-Linn County-OR
783,Coos County-Marion County-OR-1617,"Marion County, OR",1617,2016,2017,55,1553000,63,1698000,-8,-145000,Coos County,Coos County-Marion County-OR
784,Coos County-Maricopa County-AZ-1617,"Maricopa County, AZ",1617,2016,2017,54,962000,47,975000,7,-13000,Coos County,Coos County-Maricopa County-AZ
785,Coos County-Clark County-NV-1617,"Clark County, NV",1617,2016,2017,39,654000,37,783000,2,-129000,Coos County,Coos County-Clark County-NV
786,Coos County-Benton County-OR-1617,"Benton County, OR",1617,2016,2017,36,1184000,41,1067000,-5,117000,Coos County,Coos County-Benton County-OR
787,Coos County-Lincoln County-OR-1617,"Lincoln County, OR",1617,2016,2017,40,205000,45,977000,-5,-772000,Coos County,Coos County-Lincoln County-OR
789,Crook County-Deschutes County-OR-1617,"Deschutes County, OR",1617,2016,2017,932,26626000,432,10049000,500,16577000,Crook County,Crook County-Deschutes County-OR
790,Crook County-Clackamas County-OR-1617,"Clackamas County, OR",1617,2016,2017,167,7989000,38,984000,129,7005000,Crook County,Crook County-Clackamas County-OR
791,Crook County-Jefferson County-OR-1617,"Jefferson County, OR",1617,2016,2017,89,1809000,112,1985000,-23,-176000,Crook County,Crook County-Jefferson County-OR
792,Crook County-Lane County-OR-1617,"Lane County, OR",1617,2016,2017,62,22290000,41,716000,21,21574000,Crook County,Crook County-Lane County-OR
794,Curry County-Jackson County-OR-1617,"Jackson County, OR",1617,2016,2017,105,2508000,122,2580000,-17,-72000,Curry County,Curry County-Jackson County-OR
795,Curry County-Del Norte County-CA-1617,"Del Norte County, CA",1617,2016,2017,99,2141000,114,2129000,-15,12000,Curry County,Curry County-Del Norte County-CA
796,Curry County-Josephine County-OR-1617,"Josephine County, OR",1617,2016,2017,70,1836000,78,2133000,-8,-297000,Curry County,Curry County-Josephine County-OR
797,Curry County-Coos County-OR-1617,"Coos County, OR",1617,2016,2017,81,1437000,110,3056000,-29,-1619000,Curry County,Curry County-Coos County-OR
798,Curry County-Lane County-OR-1617,"Lane County, OR",1617,2016,2017,54,1401000,82,2271000,-28,-870000,Curry County,Curry County-Lane County-OR
799,Curry County-Douglas County-OR-1617,"Douglas County, OR",1617,2016,2017,37,1064000,41,964000,-4,100000,Curry County,Curry County-Douglas County-OR
801,Deschutes County-Multnomah County-OR-1617,"Multnomah County, OR",1617,2016,2017,1175,57662000,421,14119000,754,43543000,Deschutes County,Deschutes County-Multnomah County-OR
802,Deschutes County-Washington County-OR-1617,"Washington County, OR",1617,2016,2017,949,43055000,403,16782000,546,26273000,Deschutes County,Deschutes County-Washington County-OR
803,Deschutes County-Clackamas County-OR-1617,"Clackamas County, OR",1617,2016,2017,891,40337000,338,10356000,553,29981000,Deschutes County,Deschutes County-Clackamas County-OR
804,Deschutes County-Lane County-OR-1617,"Lane County, OR",1617,2016,2017,736,26021000,570,15856000,166,10165000,Deschutes County,Deschutes County-Lane County-OR
805,Deschutes County-King County-WA-1617,"King County, WA",1617,2016,2017,590,38050000,166,9366000,424,28684000,Deschutes County,Deschutes County-King County-WA
806,Deschutes County-Marion County-OR-1617,"Marion County, OR",1617,2016,2017,503,18288000,384,10911000,119,7377000,Deschutes County,Deschutes County-Marion County-OR
807,Deschutes County-Los Angeles County-CA-1617,"Los Angeles County, CA",1617,2016,2017,478,28667000,87,2753000,391,25914000,Deschutes County,Deschutes County-Los Angeles County-CA
808,Deschutes County-Crook County-OR-1617,"Crook County, OR",1617,2016,2017,432,10049000,932,26626000,-500,-16577000,Deschutes County,Deschutes County-Crook County-OR
809,Deschutes County-Jefferson County-OR-1617,"Jefferson County, OR",1617,2016,2017,417,8636000,700,14128000,-283,-5492000,Deschutes County,Deschutes County-Jefferson County-OR
810,Deschutes County-San Diego County-CA-1617,"San Diego County, CA",1617,2016,2017,400,14773000,125,4229000,275,10544000,Deschutes County,Deschutes County-San Diego County-CA
811,Deschutes County-Jackson County-OR-1617,"Jackson County, OR",1617,2016,2017,312,9842000,207,5870000,105,3972000,Deschutes County,Deschutes County-Jackson County-OR
812,Deschutes County-Orange County-CA-1617,"Orange County, CA",1617,2016,2017,354,16689000,81,2116000,273,14573000,Deschutes County,Deschutes County-Orange County-CA
813,Deschutes County-Benton County-OR-1617,"Benton County, OR",1617,2016,2017,255,8831000,128,2952000,127,5879000,Deschutes County,Deschutes County-Benton County-OR
814,Deschutes County-Maricopa County-AZ-1617,"Maricopa County, AZ",1617,2016,2017,271,9863000,327,10436000,-56,-573000,Deschutes County,Deschutes County-Maricopa County-AZ
815,Deschutes County-Clark County-WA-1617,"Clark County, WA",1617,2016,2017,284,16486000,213,12404000,71,4082000,Deschutes County,Deschutes County-Clark County-WA
816,Deschutes County-Santa Clara County-CA-1617,"Santa Clara County, CA",1617,2016,2017,251,23087000,39,2652000,212,20435000,Deschutes County,Deschutes County-Santa Clara County-CA
817,Deschutes County-Klamath County-OR-1617,"Klamath County, OR",1617,2016,2017,260,6547000,249,3960000,11,2587000,Deschutes County,Deschutes County-Klamath County-OR
818,Deschutes County-Linn County-OR-1617,"Linn County, OR",1617,2016,2017,257,7044000,198,4642000,59,2402000,Deschutes County,Deschutes County-Linn County-OR
819,Deschutes County-Riverside County-CA-1617,"Riverside County, CA",1617,2016,2017,194,7621000,81,4461000,113,3160000,Deschutes County,Deschutes County-Riverside County-CA
820,Deschutes County-Yamhill County-OR-1617,"Yamhill County, OR",1617,2016,2017,228,5881000,92,2515000,136,3366000,Deschutes County,Deschutes County-Yamhill County-OR
821,Deschutes County-Polk County-OR-1617,"Polk County, OR",1617,2016,2017,160,4535000,107,3119000,53,1416000,Deschutes County,Deschutes County-Polk County-OR
822,Deschutes County-Clark County-NV-1617,"Clark County, NV",1617,2016,2017,136,5055000,125,3544000,11,1511000,Deschutes County,Deschutes County-Clark County-NV
823,Deschutes County-Douglas County-OR-1617,"Douglas County, OR",1617,2016,2017,144,3965000,186,4063000,-42,-98000,Deschutes County,Deschutes County-Douglas County-OR
824,Deschutes County-Pierce County-WA-1617,"Pierce County, WA",1617,2016,2017,132,5597000,84,2587000,48,3010000,Deschutes County,Deschutes County-Pierce County-WA
825,Deschutes County-Snohomish County-WA-1617,"Snohomish County, WA",1617,2016,2017,126,9259000,56,1141000,70,8118000,Deschutes County,Deschutes County-Snohomish County-WA
826,Deschutes County-Ada County-ID-1617,"Ada County, ID",1617,2016,2017,107,3422000,198,5226000,-91,-1804000,Deschutes County,Deschutes County-Ada County-ID
827,Deschutes County-Lincoln County-OR-1617,"Lincoln County, OR",1617,2016,2017,127,4396000,137,2454000,-10,1942000,Deschutes County,Deschutes County-Lincoln County-OR
828,Deschutes County-Sacramento County-CA-1617,"Sacramento County, CA",1617,2016,2017,93,3982000,59,1687000,34,2295000,Deschutes County,Deschutes County-Sacramento County-CA
829,Deschutes County-Salt Lake County-UT-1617,"Salt Lake County, UT",1617,2016,2017,81,3615000,44,970000,37,2645000,Deschutes County,Deschutes County-Salt Lake County-UT
830,Deschutes County-Clatsop County-OR-1617,"Clatsop County, OR",1617,2016,2017,86,3021000,70,1787000,16,1234000,Deschutes County,Deschutes County-Clatsop County-OR
831,Deschutes County-Coos County-OR-1617,"Coos County, OR",1617,2016,2017,75,1938000,74,1189000,1,749000,Deschutes County,Deschutes County-Coos County-OR
832,Deschutes County-Travis County-TX-1617,"Travis County, TX",1617,2016,2017,66,3646000,39,2198000,27,1448000,Deschutes County,Deschutes County-Travis County-TX
833,Deschutes County-Pima County-AZ-1617,"Pima County, AZ",1617,2016,2017,71,2053000,89,2604000,-18,-551000,Deschutes County,Deschutes County-Pima County-AZ
834,Deschutes County-Wasco County-OR-1617,"Wasco County, OR",1617,2016,2017,66,2009000,61,1534000,5,475000,Deschutes County,Deschutes County-Wasco County-OR
835,Deschutes County-Shasta County-CA-1617,"Shasta County, CA",1617,2016,2017,81,1767000,47,927000,34,840000,Deschutes County,Deschutes County-Shasta County-CA
836,Deschutes County-Josephine County-OR-1617,"Josephine County, OR",1617,2016,2017,72,2586000,90,1649000,-18,937000,Deschutes County,Deschutes County-Josephine County-OR
837,Deschutes County-Washoe County-NV-1617,"Washoe County, NV",1617,2016,2017,67,1561000,55,1968000,12,-407000,Deschutes County,Deschutes County-Washoe County-NV
838,Deschutes County-Boulder County-CO-1617,"Boulder County, CO",1617,2016,2017,56,2947000,35,1420000,21,1527000,Deschutes County,Deschutes County-Boulder County-CO
839,Deschutes County-Umatilla County-OR-1617,"Umatilla County, OR",1617,2016,2017,74,2762000,82,1575000,-8,1187000,Deschutes County,Deschutes County-Umatilla County-OR
840,Deschutes County-Spokane County-WA-1617,"Spokane County, WA",1617,2016,2017,59,1515000,95,4023000,-36,-2508000,Deschutes County,Deschutes County-Spokane County-WA
841,Deschutes County-Benton County-WA-1617,"Benton County, WA",1617,2016,2017,69,2529000,60,1841000,9,688000,Deschutes County,Deschutes County-Benton County-WA
842,Deschutes County-Tillamook County-OR-1617,"Tillamook County, OR",1617,2016,2017,59,1341000,52,1666000,7,-325000,Deschutes County,Deschutes County-Tillamook County-OR
843,Deschutes County-Yavapai County-AZ-1617,"Yavapai County, AZ",1617,2016,2017,37,1539000,67,2098000,-30,-559000,Deschutes County,Deschutes County-Yavapai County-AZ
844,Deschutes County-Yakima County-WA-1617,"Yakima County, WA",1617,2016,2017,38,1567000,36,813000,2,754000,Deschutes County,Deschutes County-Yakima County-WA
845,Deschutes County-Lake County-OR-1617,"Lake County, OR",1617,2016,2017,34,1374000,39,1275000,-5,99000,Deschutes County,Deschutes County-Lake County-OR
846,Deschutes County-Union County-OR-1617,"Union County, OR",1617,2016,2017,42,1129000,40,1159000,2,-30000,Deschutes County,Deschutes County-Union County-OR
847,Deschutes County-Hawaii County-HI-1617,"Hawaii County, HI",1617,2016,2017,33,614000,61,1396000,-28,-782000,Deschutes County,Deschutes County-Hawaii County-HI
848,Deschutes County-Gallatin County-MT-1617,"Gallatin County, MT",1617,2016,2017,35,997000,46,984000,-11,13000,Deschutes County,Deschutes County-Gallatin County-MT
849,Deschutes County-Thurston County-WA-1617,"Thurston County, WA",1617,2016,2017,50,1215000,55,1482000,-5,-267000,Deschutes County,Deschutes County-Thurston County-WA
851,Douglas County-Lane County-OR-1617,"Lane County, OR",1617,2016,2017,689,15776000,753,22263000,-64,-6487000,Douglas County,Douglas County-Lane County-OR
852,Douglas County-Coos County-OR-1617,"Coos County, OR",1617,2016,2017,256,6414000,259,4867000,-3,1547000,Douglas County,Douglas County-Coos County-OR
853,Douglas County-Jackson County-OR-1617,"Jackson County, OR",1617,2016,2017,252,5025000,207,5152000,45,-127000,Douglas County,Douglas County-Jackson County-OR
854,Douglas County-Josephine County-OR-1617,"Josephine County, OR",1617,2016,2017,204,3420000,153,3291000,51,129000,Douglas County,Douglas County-Josephine County-OR
855,Douglas County-Multnomah County-OR-1617,"Multnomah County, OR",1617,2016,2017,168,4781000,105,3767000,63,1014000,Douglas County,Douglas County-Multnomah County-OR
856,Douglas County-Deschutes County-OR-1617,"Deschutes County, OR",1617,2016,2017,186,4063000,144,3965000,42,98000,Douglas County,Douglas County-Deschutes County-OR
857,Douglas County-Washington County-OR-1617,"Washington County, OR",1617,2016,2017,155,5136000,111,2208000,44,2928000,Douglas County,Douglas County-Washington County-OR
858,Douglas County-Marion County-OR-1617,"Marion County, OR",1617,2016,2017,132,3076000,130,2645000,2,431000,Douglas County,Douglas County-Marion County-OR
859,Douglas County-Clackamas County-OR-1617,"Clackamas County, OR",1617,2016,2017,94,2581000,100,2928000,-6,-347000,Douglas County,Douglas County-Clackamas County-OR
860,Douglas County-Linn County-OR-1617,"Linn County, OR",1617,2016,2017,104,1913000,123,3059000,-19,-1146000,Douglas County,Douglas County-Linn County-OR
861,Douglas County-Klamath County-OR-1617,"Klamath County, OR",1617,2016,2017,98,1922000,65,944000,33,978000,Douglas County,Douglas County-Klamath County-OR
862,Douglas County-Maricopa County-AZ-1617,"Maricopa County, AZ",1617,2016,2017,87,2697000,69,2003000,18,694000,Douglas County,Douglas County-Maricopa County-AZ
863,Douglas County-Riverside County-CA-1617,"Riverside County, CA",1617,2016,2017,77,2471000,29,1106000,48,1365000,Douglas County,Douglas County-Riverside County-CA
864,Douglas County-Benton County-OR-1617,"Benton County, OR",1617,2016,2017,57,1822000,58,1261000,-1,561000,Douglas County,Douglas County-Benton County-OR
865,Douglas County-Sacramento County-CA-1617,"Sacramento County, CA",1617,2016,2017,78,1860000,40,1003000,38,857000,Douglas County,Douglas County-Sacramento County-CA
866,Douglas County-Lincoln County-OR-1617,"Lincoln County, OR",1617,2016,2017,57,1278000,53,898000,4,380000,Douglas County,Douglas County-Lincoln County-OR
867,Douglas County-King County-WA-1617,"King County, WA",1617,2016,2017,54,1354000,38,1383000,16,-29000,Douglas County,Douglas County-King County-WA
868,Douglas County-Clark County-WA-1617,"Clark County, WA",1617,2016,2017,54,1575000,91,3247000,-37,-1672000,Douglas County,Douglas County-Clark County-WA
869,Douglas County-Curry County-OR-1617,"Curry County, OR",1617,2016,2017,41,964000,37,1064000,4,-100000,Douglas County,Douglas County-Curry County-OR
870,Douglas County-Polk County-OR-1617,"Polk County, OR",1617,2016,2017,43,851000,81,1725000,-38,-874000,Douglas County,Douglas County-Polk County-OR
875,Hood River County-Multnomah County-OR-1617,"Multnomah County, OR",1617,2016,2017,300,13095000,148,6146000,152,6949000,Hood River County,Hood River County-Multnomah County-OR
876,Hood River County-Wasco County-OR-1617,"Wasco County, OR",1617,2016,2017,191,3549000,362,8979000,-171,-5430000,Hood River County,Hood River County-Wasco County-OR
877,Hood River County-Klickitat County-WA-1617,"Klickitat County, WA",1617,2016,2017,156,5836000,199,6486000,-43,-650000,Hood River County,Hood River County-Klickitat County-WA
878,Hood River County-Washington County-OR-1617,"Washington County, OR",1617,2016,2017,71,3739000,83,2143000,-12,1596000,Hood River County,Hood River County-Washington County-OR
879,Hood River County-Clackamas County-OR-1617,"Clackamas County, OR",1617,2016,2017,63,1956000,47,981000,16,975000,Hood River County,Hood River County-Clackamas County-OR
881,Jackson County-Josephine County-OR-1617,"Josephine County, OR",1617,2016,2017,1050,26709000,1142,23756000,-92,2953000,Jackson County,Jackson County-Josephine County-OR
882,Jackson County-Los Angeles County-CA-1617,"Los Angeles County, CA",1617,2016,2017,462,16952000,136,4743000,326,12209000,Jackson County,Jackson County-Los Angeles County-CA
883,Jackson County-Multnomah County-OR-1617,"Multnomah County, OR",1617,2016,2017,401,12186000,313,12024000,88,162000,Jackson County,Jackson County-Multnomah County-OR
884,Jackson County-Lane County-OR-1617,"Lane County, OR",1617,2016,2017,355,8577000,430,9789000,-75,-1212000,Jackson County,Jackson County-Lane County-OR
885,Jackson County-Klamath County-OR-1617,"Klamath County, OR",1617,2016,2017,315,8396000,270,4900000,45,3496000,Jackson County,Jackson County-Klamath County-OR
886,Jackson County-Washington County-OR-1617,"Washington County, OR",1617,2016,2017,310,7985000,259,7175000,51,810000,Jackson County,Jackson County-Washington County-OR
887,Jackson County-Orange County-CA-1617,"Orange County, CA",1617,2016,2017,246,10050000,86,2971000,160,7079000,Jackson County,Jackson County-Orange County-CA
888,Jackson County-San Diego County-CA-1617,"San Diego County, CA",1617,2016,2017,212,6979000,124,3128000,88,3851000,Jackson County,Jackson County-San Diego County-CA
889,Jackson County-Deschutes County-OR-1617,"Deschutes County, OR",1617,2016,2017,207,5870000,312,9842000,-105,-3972000,Jackson County,Jackson County-Deschutes County-OR
890,Jackson County-Santa Clara County-CA-1617,"Santa Clara County, CA",1617,2016,2017,203,13358000,31,1185000,172,12173000,Jackson County,Jackson County-Santa Clara County-CA
891,Jackson County-Alameda County-CA-1617,"Alameda County, CA",1617,2016,2017,197,12398000,52,1964000,145,10434000,Jackson County,Jackson County-Alameda County-CA
892,Jackson County-Clackamas County-OR-1617,"Clackamas County, OR",1617,2016,2017,187,5540000,154,6206000,33,-666000,Jackson County,Jackson County-Clackamas County-OR
893,Jackson County-Douglas County-OR-1617,"Douglas County, OR",1617,2016,2017,207,5152000,252,5025000,-45,127000,Jackson County,Jackson County-Douglas County-OR
894,Jackson County-Siskiyou County-CA-1617,"Siskiyou County, CA",1617,2016,2017,174,4759000,114,1759000,60,3000000,Jackson County,Jackson County-Siskiyou County-CA
895,Jackson County-Maricopa County-AZ-1617,"Maricopa County, AZ",1617,2016,2017,197,5631000,177,4401000,20,1230000,Jackson County,Jackson County-Maricopa County-AZ
896,Jackson County-Riverside County-CA-1617,"Riverside County, CA",1617,2016,2017,181,5275000,103,2376000,78,2899000,Jackson County,Jackson County-Riverside County-CA
897,Jackson County-King County-WA-1617,"King County, WA",1617,2016,2017,158,7702000,96,3348000,62,4354000,Jackson County,Jackson County-King County-WA
898,Jackson County-Clark County-NV-1617,"Clark County, NV",1617,2016,2017,140,3960000,107,3119000,33,841000,Jackson County,Jackson County-Clark County-NV
899,Jackson County-Contra Costa County-CA-1617,"Contra Costa County, CA",1617,2016,2017,146,4813000,56,1975000,90,2838000,Jackson County,Jackson County-Contra Costa County-CA
900,Jackson County-Sacramento County-CA-1617,"Sacramento County, CA",1617,2016,2017,137,4277000,111,2499000,26,1778000,Jackson County,Jackson County-Sacramento County-CA
901,Jackson County-Shasta County-CA-1617,"Shasta County, CA",1617,2016,2017,149,3283000,105,1747000,44,1536000,Jackson County,Jackson County-Shasta County-CA
902,Jackson County-Sonoma County-CA-1617,"Sonoma County, CA",1617,2016,2017,116,4305000,66,1629000,50,2676000,Jackson County,Jackson County-Sonoma County-CA
903,Jackson County-Curry County-OR-1617,"Curry County, OR",1617,2016,2017,122,2580000,105,2508000,17,72000,Jackson County,Jackson County-Curry County-OR
904,Jackson County-Clark County-WA-1617,"Clark County, WA",1617,2016,2017,114,4117000,147,3945000,-33,172000,Jackson County,Jackson County-Clark County-WA
905,Jackson County-San Bernardino County-CA-1617,"San Bernardino County, CA",1617,2016,2017,129,2991000,62,1082000,67,1909000,Jackson County,Jackson County-San Bernardino County-CA
906,Jackson County-Benton County-OR-1617,"Benton County, OR",1617,2016,2017,93,2743000,63,1394000,30,1349000,Jackson County,Jackson County-Benton County-OR
907,Jackson County-Marion County-OR-1617,"Marion County, OR",1617,2016,2017,106,3148000,187,4420000,-81,-1272000,Jackson County,Jackson County-Marion County-OR
908,Jackson County-Washoe County-NV-1617,"Washoe County, NV",1617,2016,2017,106,3798000,54,1651000,52,2147000,Jackson County,Jackson County-Washoe County-NV
909,Jackson County-Coos County-OR-1617,"Coos County, OR",1617,2016,2017,115,2699000,146,3185000,-31,-486000,Jackson County,Jackson County-Coos County-OR
910,Jackson County-Humboldt County-CA-1617,"Humboldt County, CA",1617,2016,2017,97,2898000,32,945000,65,1953000,Jackson County,Jackson County-Humboldt County-CA
911,Jackson County-Snohomish County-WA-1617,"Snohomish County, WA",1617,2016,2017,105,2638000,47,1441000,58,1197000,Jackson County,Jackson County-Snohomish County-WA
912,Jackson County-Linn County-OR-1617,"Linn County, OR",1617,2016,2017,91,1345000,95,1935000,-4,-590000,Jackson County,Jackson County-Linn County-OR
913,Jackson County-Pierce County-WA-1617,"Pierce County, WA",1617,2016,2017,80,2541000,62,1076000,18,1465000,Jackson County,Jackson County-Pierce County-WA
914,Jackson County-Ada County-ID-1617,"Ada County, ID",1617,2016,2017,87,1687000,106,3513000,-19,-1826000,Jackson County,Jackson County-Ada County-ID
915,Jackson County-Salt Lake County-UT-1617,"Salt Lake County, UT",1617,2016,2017,79,2391000,54,1148000,25,1243000,Jackson County,Jackson County-Salt Lake County-UT
916,Jackson County-San Francisco County-CA-1617,"San Francisco County, CA",1617,2016,2017,59,4945000,25,1186000,34,3759000,Jackson County,Jackson County-San Francisco County-CA
917,Jackson County-Kern County-CA-1617,"Kern County, CA",1617,2016,2017,78,1644000,39,497000,39,1147000,Jackson County,Jackson County-Kern County-CA
918,Jackson County-Placer County-CA-1617,"Placer County, CA",1617,2016,2017,68,2685000,63,2094000,5,591000,Jackson County,Jackson County-Placer County-CA
919,Jackson County-Lincoln County-OR-1617,"Lincoln County, OR",1617,2016,2017,49,1194000,54,1553000,-5,-359000,Jackson County,Jackson County-Lincoln County-OR
920,Jackson County-Spokane County-WA-1617,"Spokane County, WA",1617,2016,2017,39,1200000,50,2111000,-11,-911000,Jackson County,Jackson County-Spokane County-WA
921,Jackson County-Yamhill County-OR-1617,"Yamhill County, OR",1617,2016,2017,48,1051000,41,1037000,7,14000,Jackson County,Jackson County-Yamhill County-OR
922,Jackson County-Pima County-AZ-1617,"Pima County, AZ",1617,2016,2017,41,1290000,44,1227000,-3,63000,Jackson County,Jackson County-Pima County-AZ
923,Jackson County-Polk County-OR-1617,"Polk County, OR",1617,2016,2017,43,927000,64,1688000,-21,-761000,Jackson County,Jackson County-Polk County-OR
925,Jefferson County-Deschutes County-OR-1617,"Deschutes County, OR",1617,2016,2017,700,14128000,417,8636000,283,5492000,Jefferson County,Jefferson County-Deschutes County-OR
926,Jefferson County-Crook County-OR-1617,"Crook County, OR",1617,2016,2017,112,1985000,89,1809000,23,176000,Jefferson County,Jefferson County-Crook County-OR
927,Jefferson County-Clackamas County-OR-1617,"Clackamas County, OR",1617,2016,2017,92,3039000,59,3297000,33,-258000,Jefferson County,Jefferson County-Clackamas County-OR
928,Jefferson County-Multnomah County-OR-1617,"Multnomah County, OR",1617,2016,2017,78,2191000,35,1473000,43,718000,Jefferson County,Jefferson County-Multnomah County-OR
930,Josephine County-Jackson County-OR-1617,"Jackson County, OR",1617,2016,2017,1142,23756000,1050,26709000,92,-2953000,Josephine County,Josephine County-Jackson County-OR
931,Josephine County-Los Angeles County-CA-1617,"Los Angeles County, CA",1617,2016,2017,188,7408000,53,2554000,135,4854000,Josephine County,Josephine County-Los Angeles County-CA
932,Josephine County-Multnomah County-OR-1617,"Multnomah County, OR",1617,2016,2017,124,2984000,90,1674000,34,1310000,Josephine County,Josephine County-Multnomah County-OR
933,Josephine County-Douglas County-OR-1617,"Douglas County, OR",1617,2016,2017,153,3291000,204,3420000,-51,-129000,Josephine County,Josephine County-Douglas County-OR
934,Josephine County-Lane County-OR-1617,"Lane County, OR",1617,2016,2017,159,3172000,194,4001000,-35,-829000,Josephine County,Josephine County-Lane County-OR
935,Josephine County-Klamath County-OR-1617,"Klamath County, OR",1617,2016,2017,98,2095000,51,671000,47,1424000,Josephine County,Josephine County-Klamath County-OR
936,Josephine County-Orange County-CA-1617,"Orange County, CA",1617,2016,2017,77,3065000,35,1081000,42,1984000,Josephine County,Josephine County-Orange County-CA
937,Josephine County-Washington County-OR-1617,"Washington County, OR",1617,2016,2017,90,2647000,72,1714000,18,933000,Josephine County,Josephine County-Washington County-OR
938,Josephine County-Clackamas County-OR-1617,"Clackamas County, OR",1617,2016,2017,90,2296000,59,1299000,31,997000,Josephine County,Josephine County-Clackamas County-OR
939,Josephine County-Deschutes County-OR-1617,"Deschutes County, OR",1617,2016,2017,90,1649000,72,2586000,18,-937000,Josephine County,Josephine County-Deschutes County-OR
940,Josephine County-Clark County-NV-1617,"Clark County, NV",1617,2016,2017,82,1785000,65,1291000,17,494000,Josephine County,Josephine County-Clark County-NV
941,Josephine County-Curry County-OR-1617,"Curry County, OR",1617,2016,2017,78,2133000,70,1836000,8,297000,Josephine County,Josephine County-Curry County-OR
942,Josephine County-Marion County-OR-1617,"Marion County, OR",1617,2016,2017,72,1759000,77,1893000,-5,-134000,Josephine County,Josephine County-Marion County-OR
943,Josephine County-Maricopa County-AZ-1617,"Maricopa County, AZ",1617,2016,2017,57,1041000,93,2776000,-36,-1735000,Josephine County,Josephine County-Maricopa County-AZ
944,Josephine County-Coos County-OR-1617,"Coos County, OR",1617,2016,2017,41,935000,66,3201000,-25,-2266000,Josephine County,Josephine County-Coos County-OR
946,Klamath County-Jackson County-OR-1617,"Jackson County, OR",1617,2016,2017,270,4900000,315,8396000,-45,-3496000,Klamath County,Klamath County-Jackson County-OR
947,Klamath County-Deschutes County-OR-1617,"Deschutes County, OR",1617,2016,2017,249,3960000,260,6547000,-11,-2587000,Klamath County,Klamath County-Deschutes County-OR
948,Klamath County-Lane County-OR-1617,"Lane County, OR",1617,2016,2017,164,3952000,161,3940000,3,12000,Klamath County,Klamath County-Lane County-OR
949,Klamath County-Siskiyou County-CA-1617,"Siskiyou County, CA",1617,2016,2017,173,3020000,79,1194000,94,1826000,Klamath County,Klamath County-Siskiyou County-CA
950,Klamath County-Multnomah County-OR-1617,"Multnomah County, OR",1617,2016,2017,105,2512000,68,1819000,37,693000,Klamath County,Klamath County-Multnomah County-OR
951,Klamath County-Washington County-OR-1617,"Washington County, OR",1617,2016,2017,82,2227000,109,2523000,-27,-296000,Klamath County,Klamath County-Washington County-OR
952,Klamath County-Marion County-OR-1617,"Marion County, OR",1617,2016,2017,81,2123000,103,2265000,-22,-142000,Klamath County,Klamath County-Marion County-OR
953,Klamath County-Clackamas County-OR-1617,"Clackamas County, OR",1617,2016,2017,83,3990000,63,1437000,20,2553000,Klamath County,Klamath County-Clackamas County-OR
954,Klamath County-Linn County-OR-1617,"Linn County, OR",1617,2016,2017,69,1595000,80,1586000,-11,9000,Klamath County,Klamath County-Linn County-OR
955,Klamath County-Shasta County-CA-1617,"Shasta County, CA",1617,2016,2017,52,968000,39,693000,13,275000,Klamath County,Klamath County-Shasta County-CA
956,Klamath County-Douglas County-OR-1617,"Douglas County, OR",1617,2016,2017,65,944000,98,1922000,-33,-978000,Klamath County,Klamath County-Douglas County-OR
957,Klamath County-Josephine County-OR-1617,"Josephine County, OR",1617,2016,2017,51,671000,98,2095000,-47,-1424000,Klamath County,Klamath County-Josephine County-OR
958,Klamath County-Lake County-OR-1617,"Lake County, OR",1617,2016,2017,60,876000,58,2183000,2,-1307000,Klamath County,Klamath County-Lake County-OR
959,Klamath County-Maricopa County-AZ-1617,"Maricopa County, AZ",1617,2016,2017,47,773000,50,815000,-3,-42000,Klamath County,Klamath County-Maricopa County-AZ
960,Klamath County-Washoe County-NV-1617,"Washoe County, NV",1617,2016,2017,36,1484000,37,739000,-1,745000,Klamath County,Klamath County-Washoe County-NV
961,Klamath County-King County-WA-1617,"King County, WA",1617,2016,2017,34,1000000,39,1582000,-5,-582000,Klamath County,Klamath County-King County-WA
963,Lake County-Klamath County-OR-1617,"Klamath County, OR",1617,2016,2017,58,2183000,60,876000,-2,1307000,Lake County,Lake County-Klamath County-OR
964,Lake County-Deschutes County-OR-1617,"Deschutes County, OR",1617,2016,2017,39,1275000,34,1374000,5,-99000,Lake County,Lake County-Deschutes County-OR
966,Lane County-Multnomah County-OR-1617,"Multnomah County, OR",1617,2016,2017,918,31928000,1101,34347000,-183,-2419000,Lane County,Lane County-Multnomah County-OR
967,Lane County-Linn County-OR-1617,"Linn County, OR",1617,2016,2017,792,16498000,1045,24840000,-253,-8342000,Lane County,Lane County-Linn County-OR
968,Lane County-Douglas County-OR-1617,"Douglas County, OR",1617,2016,2017,753,22263000,689,15776000,64,6487000,Lane County,Lane County-Douglas County-OR
969,Lane County-Washington County-OR-1617,"Washington County, OR",1617,2016,2017,608,19267000,665,20000000,-57,-733000,Lane County,Lane County-Washington County-OR
970,Lane County-Deschutes County-OR-1617,"Deschutes County, OR",1617,2016,2017,570,15856000,736,26021000,-166,-10165000,Lane County,Lane County-Deschutes County-OR
971,Lane County-Marion County-OR-1617,"Marion County, OR",1617,2016,2017,580,15522000,536,14886000,44,636000,Lane County,Lane County-Marion County-OR
972,Lane County-Los Angeles County-CA-1617,"Los Angeles County, CA",1617,2016,2017,597,15711000,215,5953000,382,9758000,Lane County,Lane County-Los Angeles County-CA
973,Lane County-Benton County-OR-1617,"Benton County, OR",1617,2016,2017,462,12352000,404,10115000,58,2237000,Lane County,Lane County-Benton County-OR
974,Lane County-Jackson County-OR-1617,"Jackson County, OR",1617,2016,2017,430,9789000,355,8577000,75,1212000,Lane County,Lane County-Jackson County-OR
975,Lane County-Clackamas County-OR-1617,"Clackamas County, OR",1617,2016,2017,379,12078000,425,14292000,-46,-2214000,Lane County,Lane County-Clackamas County-OR
976,Lane County-King County-WA-1617,"King County, WA",1617,2016,2017,335,15015000,345,11469000,-10,3546000,Lane County,Lane County-King County-WA
977,Lane County-San Diego County-CA-1617,"San Diego County, CA",1617,2016,2017,371,10752000,162,7623000,209,3129000,Lane County,Lane County-San Diego County-CA
978,Lane County-Coos County-OR-1617,"Coos County, OR",1617,2016,2017,353,8198000,257,5606000,96,2592000,Lane County,Lane County-Coos County-OR
979,Lane County-Maricopa County-AZ-1617,"Maricopa County, AZ",1617,2016,2017,320,9523000,302,10937000,18,-1414000,Lane County,Lane County-Maricopa County-AZ
980,Lane County-Orange County-CA-1617,"Orange County, CA",1617,2016,2017,293,11189000,113,5029000,180,6160000,Lane County,Lane County-Orange County-CA
981,Lane County-Santa Clara County-CA-1617,"Santa Clara County, CA",1617,2016,2017,270,11988000,63,2514000,207,9474000,Lane County,Lane County-Santa Clara County-CA
982,Lane County-Clark County-WA-1617,"Clark County, WA",1617,2016,2017,234,6039000,303,9931000,-69,-3892000,Lane County,Lane County-Clark County-WA
983,Lane County-Lincoln County-OR-1617,"Lincoln County, OR",1617,2016,2017,208,4790000,175,3959000,33,831000,Lane County,Lane County-Lincoln County-OR
984,Lane County-Sacramento County-CA-1617,"Sacramento County, CA",1617,2016,2017,207,6442000,98,2907000,109,3535000,Lane County,Lane County-Sacramento County-CA
985,Lane County-Clark County-NV-1617,"Clark County, NV",1617,2016,2017,215,5162000,135,4005000,80,1157000,Lane County,Lane County-Clark County-NV
986,Lane County-Riverside County-CA-1617,"Riverside County, CA",1617,2016,2017,214,6038000,87,2121000,127,3917000,Lane County,Lane County-Riverside County-CA
987,Lane County-Alameda County-CA-1617,"Alameda County, CA",1617,2016,2017,188,7238000,70,2596000,118,4642000,Lane County,Lane County-Alameda County-CA
988,Lane County-Josephine County-OR-1617,"Josephine County, OR",1617,2016,2017,194,4001000,159,3172000,35,829000,Lane County,Lane County-Josephine County-OR
989,Lane County-Contra Costa County-CA-1617,"Contra Costa County, CA",1617,2016,2017,174,6732000,48,2059000,126,4673000,Lane County,Lane County-Contra Costa County-CA
990,Lane County-Polk County-OR-1617,"Polk County, OR",1617,2016,2017,142,3541000,156,4021000,-14,-480000,Lane County,Lane County-Polk County-OR
991,Lane County-Klamath County-OR-1617,"Klamath County, OR",1617,2016,2017,161,3940000,164,3952000,-3,-12000,Lane County,Lane County-Klamath County-OR
992,Lane County-Pierce County-WA-1617,"Pierce County, WA",1617,2016,2017,159,4422000,123,3074000,36,1348000,Lane County,Lane County-Pierce County-WA
993,Lane County-San Bernardino County-CA-1617,"San Bernardino County, CA",1617,2016,2017,145,4451000,54,993000,91,3458000,Lane County,Lane County-San Bernardino County-CA
994,Lane County-Washoe County-NV-1617,"Washoe County, NV",1617,2016,2017,145,3713000,82,3312000,63,401000,Lane County,Lane County-Washoe County-NV
995,Lane County-Salt Lake County-UT-1617,"Salt Lake County, UT",1617,2016,2017,140,4251000,104,4663000,36,-412000,Lane County,Lane County-Salt Lake County-UT
996,Lane County-Ada County-ID-1617,"Ada County, ID",1617,2016,2017,128,3094000,165,5912000,-37,-2818000,Lane County,Lane County-Ada County-ID
997,Lane County-Sonoma County-CA-1617,"Sonoma County, CA",1617,2016,2017,138,4057000,41,968000,97,3089000,Lane County,Lane County-Sonoma County-CA
998,Lane County-Pima County-AZ-1617,"Pima County, AZ",1617,2016,2017,130,3821000,87,3120000,43,701000,Lane County,Lane County-Pima County-AZ
999,Lane County-Cook County-IL-1617,"Cook County, IL",1617,2016,2017,89,3652000,50,2099000,39,1553000,Lane County,Lane County-Cook County-IL
1000,Lane County-Honolulu County-HI-1617,"Honolulu County, HI",1617,2016,2017,131,3416000,73,1270000,58,2146000,Lane County,Lane County-Honolulu County-HI
1001,Lane County-Spokane County-WA-1617,"Spokane County, WA",1617,2016,2017,110,2475000,85,2106000,25,369000,Lane County,Lane County-Spokane County-WA
1002,Lane County-Yamhill County-OR-1617,"Yamhill County, OR",1617,2016,2017,121,2596000,93,2479000,28,117000,Lane County,Lane County-Yamhill County-OR
1003,Lane County-Travis County-TX-1617,"Travis County, TX",1617,2016,2017,101,2576000,53,1605000,48,971000,Lane County,Lane County-Travis County-TX
1004,Lane County-San Francisco County-CA-1617,"San Francisco County, CA",1617,2016,2017,73,4576000,44,1694000,29,2882000,Lane County,Lane County-San Francisco County-CA
1005,Lane County-San Mateo County-CA-1617,"San Mateo County, CA",1617,2016,2017,85,6667000,22,1185000,63,5482000,Lane County,Lane County-San Mateo County-CA
1006,Lane County-Snohomish County-WA-1617,"Snohomish County, WA",1617,2016,2017,98,2502000,103,2708000,-5,-206000,Lane County,Lane County-Snohomish County-WA
1007,Lane County-Humboldt County-CA-1617,"Humboldt County, CA",1617,2016,2017,96,2691000,34,803000,62,1888000,Lane County,Lane County-Humboldt County-CA
1008,Lane County-San Luis Obispo County-CA-1617,"San Luis Obispo County, CA",1617,2016,2017,78,1909000,30,956000,48,953000,Lane County,Lane County-San Luis Obispo County-CA
1009,Lane County-Curry County-OR-1617,"Curry County, OR",1617,2016,2017,82,2271000,54,1401000,28,870000,Lane County,Lane County-Curry County-OR
1010,Lane County-Denver County-CO-1617,"Denver County, CO",1617,2016,2017,65,2318000,50,2376000,15,-58000,Lane County,Lane County-Denver County-CO
1011,Lane County-Harris County-TX-1617,"Harris County, TX",1617,2016,2017,75,3141000,58,1113000,17,2028000,Lane County,Lane County-Harris County-TX
1012,Lane County-Anchorage Municipality-AK-1617,"Anchorage Municipality, AK",1617,2016,2017,66,2162000,49,1406000,17,756000,Lane County,Lane County-Anchorage Municipality-AK
1013,Lane County-Placer County-CA-1617,"Placer County, CA",1617,2016,2017,76,2804000,34,1131000,42,1673000,Lane County,Lane County-Placer County-CA
1014,Lane County-Boulder County-CO-1617,"Boulder County, CO",1617,2016,2017,54,1919000,27,864000,27,1055000,Lane County,Lane County-Boulder County-CO
1015,Lane County-Shasta County-CA-1617,"Shasta County, CA",1617,2016,2017,72,1574000,44,856000,28,718000,Lane County,Lane County-Shasta County-CA
1016,Lane County-Butte County-CA-1617,"Butte County, CA",1617,2016,2017,71,1828000,31,625000,40,1203000,Lane County,Lane County-Butte County-CA
1017,Lane County-Thurston County-WA-1617,"Thurston County, WA",1617,2016,2017,65,1268000,80,1853000,-15,-585000,Lane County,Lane County-Thurston County-WA
1018,Lane County-El Paso County-CO-1617,"El Paso County, CO",1617,2016,2017,67,1065000,48,847000,19,218000,Lane County,Lane County-El Paso County-CO
1019,Lane County-Fresno County-CA-1617,"Fresno County, CA",1617,2016,2017,59,1553000,36,1248000,23,305000,Lane County,Lane County-Fresno County-CA
1020,Lane County-Canyon County-ID-1617,"Canyon County, ID",1617,2016,2017,65,1541000,41,1012000,24,529000,Lane County,Lane County-Canyon County-ID
1021,Lane County-Umatilla County-OR-1617,"Umatilla County, OR",1617,2016,2017,47,1180000,79,1342000,-32,-162000,Lane County,Lane County-Umatilla County-OR
1022,Lane County-Kitsap County-WA-1617,"Kitsap County, WA",1617,2016,2017,59,1307000,42,1393000,17,-86000,Lane County,Lane County-Kitsap County-WA
1023,Lane County-Yavapai County-AZ-1617,"Yavapai County, AZ",1617,2016,2017,48,1403000,34,938000,14,465000,Lane County,Lane County-Yavapai County-AZ
1024,Lane County-Tillamook County-OR-1617,"Tillamook County, OR",1617,2016,2017,55,1147000,37,1081000,18,66000,Lane County,Lane County-Tillamook County-OR
1025,Lane County-Missoula County-MT-1617,"Missoula County, MT",1617,2016,2017,34,693000,38,797000,-4,-104000,Lane County,Lane County-Missoula County-MT
1026,Lane County-Clatsop County-OR-1617,"Clatsop County, OR",1617,2016,2017,46,1196000,67,1074000,-21,122000,Lane County,Lane County-Clatsop County-OR
1027,Lane County-Mohave County-AZ-1617,"Mohave County, AZ",1617,2016,2017,56,1005000,46,921000,10,84000,Lane County,Lane County-Mohave County-AZ
1028,Lane County-Hennepin County-MN-1617,"Hennepin County, MN",1617,2016,2017,35,928000,50,1635000,-15,-707000,Lane County,Lane County-Hennepin County-MN
1029,Lane County-Whatcom County-WA-1617,"Whatcom County, WA",1617,2016,2017,37,656000,49,1370000,-12,-714000,Lane County,Lane County-Whatcom County-WA
1030,Lane County-Crook County-OR-1617,"Crook County, OR",1617,2016,2017,41,716000,62,22290000,-21,-21574000,Lane County,Lane County-Crook County-OR
1031,Lane County-Kootenai County-ID-1617,"Kootenai County, ID",1617,2016,2017,33,673000,37,804000,-4,-131000,Lane County,Lane County-Kootenai County-ID
1032,Lane County-Cowlitz County-WA-1617,"Cowlitz County, WA",1617,2016,2017,37,870000,54,1087000,-17,-217000,Lane County,Lane County-Cowlitz County-WA
1033,Lane County-Dane County-WI-1617,"Dane County, WI",1617,2016,2017,36,1285000,39,1089000,-3,196000,Lane County,Lane County-Dane County-WI
1034,Lane County-District of Columbia-DC-1617,"District of Columbia, DC",1617,2016,2017,23,1142000,26,994000,-3,148000,Lane County,Lane County-District of Columbia-DC
1036,Lincoln County-Multnomah County-OR-1617,"Multnomah County, OR",1617,2016,2017,283,8749000,133,4354000,150,4395000,Lincoln County,Lincoln County-Multnomah County-OR
1037,Lincoln County-Washington County-OR-1617,"Washington County, OR",1617,2016,2017,241,9971000,110,3095000,131,6876000,Lincoln County,Lincoln County-Washington County-OR
1038,Lincoln County-Marion County-OR-1617,"Marion County, OR",1617,2016,2017,256,7738000,198,4906000,58,2832000,Lincoln County,Lincoln County-Marion County-OR
1039,Lincoln County-Lane County-OR-1617,"Lane County, OR",1617,2016,2017,175,3959000,208,4790000,-33,-831000,Lincoln County,Lincoln County-Lane County-OR
1040,Lincoln County-Clackamas County-OR-1617,"Clackamas County, OR",1617,2016,2017,152,7087000,92,3903000,60,3184000,Lincoln County,Lincoln County-Clackamas County-OR
1041,Lincoln County-Benton County-OR-1617,"Benton County, OR",1617,2016,2017,130,3520000,187,5247000,-57,-1727000,Lincoln County,Lincoln County-Benton County-OR
1042,Lincoln County-Deschutes County-OR-1617,"Deschutes County, OR",1617,2016,2017,137,2454000,127,4396000,10,-1942000,Lincoln County,Lincoln County-Deschutes County-OR
1043,Lincoln County-Linn County-OR-1617,"Linn County, OR",1617,2016,2017,141,2763000,181,3640000,-40,-877000,Lincoln County,Lincoln County-Linn County-OR
1044,Lincoln County-Polk County-OR-1617,"Polk County, OR",1617,2016,2017,115,2910000,101,2418000,14,492000,Lincoln County,Lincoln County-Polk County-OR
1045,Lincoln County-Yamhill County-OR-1617,"Yamhill County, OR",1617,2016,2017,122,3091000,80,1349000,42,1742000,Lincoln County,Lincoln County-Yamhill County-OR
1046,Lincoln County-Maricopa County-AZ-1617,"Maricopa County, AZ",1617,2016,2017,89,2711000,71,2054000,18,657000,Lincoln County,Lincoln County-Maricopa County-AZ
1047,Lincoln County-Clark County-WA-1617,"Clark County, WA",1617,2016,2017,86,2103000,82,3019000,4,-916000,Lincoln County,Lincoln County-Clark County-WA
1048,Lincoln County-Tillamook County-OR-1617,"Tillamook County, OR",1617,2016,2017,70,1992000,47,1055000,23,937000,Lincoln County,Lincoln County-Tillamook County-OR
1049,Lincoln County-Clark County-NV-1617,"Clark County, NV",1617,2016,2017,89,1987000,34,557000,55,1430000,Lincoln County,Lincoln County-Clark County-NV
1050,Lincoln County-Jackson County-OR-1617,"Jackson County, OR",1617,2016,2017,54,1553000,49,1194000,5,359000,Lincoln County,Lincoln County-Jackson County-OR
1051,Lincoln County-Douglas County-OR-1617,"Douglas County, OR",1617,2016,2017,53,898000,57,1278000,-4,-380000,Lincoln County,Lincoln County-Douglas County-OR
1052,Lincoln County-Coos County-OR-1617,"Coos County, OR",1617,2016,2017,45,977000,40,205000,5,772000,Lincoln County,Lincoln County-Coos County-OR
1054,Linn County-Benton County-OR-1617,"Benton County, OR",1617,2016,2017,1750,47008000,1290,31987000,460,15021000,Linn County,Linn County-Benton County-OR
1055,Linn County-Marion County-OR-1617,"Marion County, OR",1617,2016,2017,1666,39223000,1277,31355000,389,7868000,Linn County,Linn County-Marion County-OR
1056,Linn County-Lane County-OR-1617,"Lane County, OR",1617,2016,2017,1045,24840000,792,16498000,253,8342000,Linn County,Linn County-Lane County-OR
1057,Linn County-Polk County-OR-1617,"Polk County, OR",1617,2016,2017,317,7410000,265,6540000,52,870000,Linn County,Linn County-Polk County-OR
1058,Linn County-Multnomah County-OR-1617,"Multnomah County, OR",1617,2016,2017,247,6574000,158,4243000,89,2331000,Linn County,Linn County-Multnomah County-OR
1059,Linn County-Clackamas County-OR-1617,"Clackamas County, OR",1617,2016,2017,258,6532000,173,5656000,85,876000,Linn County,Linn County-Clackamas County-OR
1060,Linn County-Washington County-OR-1617,"Washington County, OR",1617,2016,2017,257,8095000,201,5644000,56,2451000,Linn County,Linn County-Washington County-OR
1061,Linn County-Deschutes County-OR-1617,"Deschutes County, OR",1617,2016,2017,198,4642000,257,7044000,-59,-2402000,Linn County,Linn County-Deschutes County-OR
1062,Linn County-Lincoln County-OR-1617,"Lincoln County, OR",1617,2016,2017,181,3640000,141,2763000,40,877000,Linn County,Linn County-Lincoln County-OR
1063,Linn County-Douglas County-OR-1617,"Douglas County, OR",1617,2016,2017,123,3059000,104,1913000,19,1146000,Linn County,Linn County-Douglas County-OR
1064,Linn County-Maricopa County-AZ-1617,"Maricopa County, AZ",1617,2016,2017,95,2328000,72,1091000,23,1237000,Linn County,Linn County-Maricopa County-AZ
1065,Linn County-Coos County-OR-1617,"Coos County, OR",1617,2016,2017,85,1692000,83,1607000,2,85000,Linn County,Linn County-Coos County-OR
1066,Linn County-Jackson County-OR-1617,"Jackson County, OR",1617,2016,2017,95,1935000,91,1345000,4,590000,Linn County,Linn County-Jackson County-OR
1067,Linn County-Los Angeles County-CA-1617,"Los Angeles County, CA",1617,2016,2017,115,2101000,27,568000,88,1533000,Linn County,Linn County-Los Angeles County-CA
1068,Linn County-Yamhill County-OR-1617,"Yamhill County, OR",1617,2016,2017,91,1961000,66,1725000,25,236000,Linn County,Linn County-Yamhill County-OR
1069,Linn County-Clark County-WA-1617,"Clark County, WA",1617,2016,2017,93,2319000,94,2006000,-1,313000,Linn County,Linn County-Clark County-WA
1070,Linn County-King County-WA-1617,"King County, WA",1617,2016,2017,69,2128000,57,1227000,12,901000,Linn County,Linn County-King County-WA
1071,Linn County-Pierce County-WA-1617,"Pierce County, WA",1617,2016,2017,70,1355000,34,947000,36,408000,Linn County,Linn County-Pierce County-WA
1072,Linn County-Klamath County-OR-1617,"Klamath County, OR",1617,2016,2017,80,1586000,69,1595000,11,-9000,Linn County,Linn County-Klamath County-OR
1073,Linn County-Umatilla County-OR-1617,"Umatilla County, OR",1617,2016,2017,64,1425000,39,999000,25,426000,Linn County,Linn County-Umatilla County-OR
1074,Linn County-Clark County-NV-1617,"Clark County, NV",1617,2016,2017,47,896000,46,1100000,1,-204000,Linn County,Linn County-Clark County-NV
1076,Malheur County-Payette County-ID-1617,"Payette County, ID",1617,2016,2017,412,5068000,320,5705000,92,-637000,Malheur County,Malheur County-Payette County-ID
1077,Malheur County-Canyon County-ID-1617,"Canyon County, ID",1617,2016,2017,226,2804000,218,4991000,8,-2187000,Malheur County,Malheur County-Canyon County-ID
1078,Malheur County-Ada County-ID-1617,"Ada County, ID",1617,2016,2017,86,1674000,150,8036000,-64,-6362000,Malheur County,Malheur County-Ada County-ID
1080,Marion County-Polk County-OR-1617,"Polk County, OR",1617,2016,2017,3058,79173000,3271,78321000,-213,852000,Marion County,Marion County-Polk County-OR
1081,Marion County-Clackamas County-OR-1617,"Clackamas County, OR",1617,2016,2017,2554,70252000,1531,44951000,1023,25301000,Marion County,Marion County-Clackamas County-OR
1082,Marion County-Washington County-OR-1617,"Washington County, OR",1617,2016,2017,1868,48969000,1027,29767000,841,19202000,Marion County,Marion County-Washington County-OR
1083,Marion County-Multnomah County-OR-1617,"Multnomah County, OR",1617,2016,2017,1493,41700000,966,29973000,527,11727000,Marion County,Marion County-Multnomah County-OR
1084,Marion County-Linn County-OR-1617,"Linn County, OR",1617,2016,2017,1277,31355000,1666,39223000,-389,-7868000,Marion County,Marion County-Linn County-OR
1085,Marion County-Yamhill County-OR-1617,"Yamhill County, OR",1617,2016,2017,695,19765000,500,10042000,195,9723000,Marion County,Marion County-Yamhill County-OR
1086,Marion County-Lane County-OR-1617,"Lane County, OR",1617,2016,2017,536,14886000,580,15522000,-44,-636000,Marion County,Marion County-Lane County-OR
1087,Marion County-Benton County-OR-1617,"Benton County, OR",1617,2016,2017,415,12996000,335,8475000,80,4521000,Marion County,Marion County-Benton County-OR
1088,Marion County-Deschutes County-OR-1617,"Deschutes County, OR",1617,2016,2017,384,10911000,503,18288000,-119,-7377000,Marion County,Marion County-Deschutes County-OR
1089,Marion County-Clark County-WA-1617,"Clark County, WA",1617,2016,2017,376,8814000,489,11570000,-113,-2756000,Marion County,Marion County-Clark County-WA
1090,Marion County-Los Angeles County-CA-1617,"Los Angeles County, CA",1617,2016,2017,375,8004000,104,2777000,271,5227000,Marion County,Marion County-Los Angeles County-CA
1091,Marion County-Maricopa County-AZ-1617,"Maricopa County, AZ",1617,2016,2017,262,7155000,296,7856000,-34,-701000,Marion County,Marion County-Maricopa County-AZ
1092,Marion County-San Diego County-CA-1617,"San Diego County, CA",1617,2016,2017,243,6248000,125,3152000,118,3096000,Marion County,Marion County-San Diego County-CA
1093,Marion County-King County-WA-1617,"King County, WA",1617,2016,2017,184,6470000,187,5085000,-3,1385000,Marion County,Marion County-King County-WA
1094,Marion County-Jackson County-OR-1617,"Jackson County, OR",1617,2016,2017,187,4420000,106,3148000,81,1272000,Marion County,Marion County-Jackson County-OR
1095,Marion County-Lincoln County-OR-1617,"Lincoln County, OR",1617,2016,2017,198,4906000,256,7738000,-58,-2832000,Marion County,Marion County-Lincoln County-OR
1096,Marion County-Orange County-CA-1617,"Orange County, CA",1617,2016,2017,141,4624000,57,1369000,84,3255000,Marion County,Marion County-Orange County-CA
1097,Marion County-Clark County-NV-1617,"Clark County, NV",1617,2016,2017,153,3887000,138,5967000,15,-2080000,Marion County,Marion County-Clark County-NV
1098,Marion County-Douglas County-OR-1617,"Douglas County, OR",1617,2016,2017,130,2645000,132,3076000,-2,-431000,Marion County,Marion County-Douglas County-OR
1099,Marion County-Pierce County-WA-1617,"Pierce County, WA",1617,2016,2017,165,5446000,112,3396000,53,2050000,Marion County,Marion County-Pierce County-WA
1100,Marion County-Riverside County-CA-1617,"Riverside County, CA",1617,2016,2017,155,3130000,70,3094000,85,36000,Marion County,Marion County-Riverside County-CA
1101,Marion County-Santa Clara County-CA-1617,"Santa Clara County, CA",1617,2016,2017,123,4452000,42,1535000,81,2917000,Marion County,Marion County-Santa Clara County-CA
1102,Marion County-Snohomish County-WA-1617,"Snohomish County, WA",1617,2016,2017,128,3151000,88,2004000,40,1147000,Marion County,Marion County-Snohomish County-WA
1103,Marion County-Sacramento County-CA-1617,"Sacramento County, CA",1617,2016,2017,123,3341000,60,1608000,63,1733000,Marion County,Marion County-Sacramento County-CA
1104,Marion County-Klamath County-OR-1617,"Klamath County, OR",1617,2016,2017,103,2265000,81,2123000,22,142000,Marion County,Marion County-Klamath County-OR
1105,Marion County-Honolulu County-HI-1617,"Honolulu County, HI",1617,2016,2017,103,2478000,35,789000,68,1689000,Marion County,Marion County-Honolulu County-HI
1106,Marion County-Josephine County-OR-1617,"Josephine County, OR",1617,2016,2017,77,1893000,72,1759000,5,134000,Marion County,Marion County-Josephine County-OR
1107,Marion County-Washoe County-NV-1617,"Washoe County, NV",1617,2016,2017,60,1394000,44,1068000,16,326000,Marion County,Marion County-Washoe County-NV
1108,Marion County-Umatilla County-OR-1617,"Umatilla County, OR",1617,2016,2017,88,2016000,108,2329000,-20,-313000,Marion County,Marion County-Umatilla County-OR
1109,Marion County-Coos County-OR-1617,"Coos County, OR",1617,2016,2017,63,1698000,55,1553000,8,145000,Marion County,Marion County-Coos County-OR
1110,Marion County-Thurston County-WA-1617,"Thurston County, WA",1617,2016,2017,69,2031000,80,2456000,-11,-425000,Marion County,Marion County-Thurston County-WA
1111,Marion County-Ada County-ID-1617,"Ada County, ID",1617,2016,2017,70,2017000,114,3356000,-44,-1339000,Marion County,Marion County-Ada County-ID
1112,Marion County-Spokane County-WA-1617,"Spokane County, WA",1617,2016,2017,72,1467000,84,2030000,-12,-563000,Marion County,Marion County-Spokane County-WA
1113,Marion County-Pima County-AZ-1617,"Pima County, AZ",1617,2016,2017,74,1517000,51,1327000,23,190000,Marion County,Marion County-Pima County-AZ
1114,Marion County-Clatsop County-OR-1617,"Clatsop County, OR",1617,2016,2017,56,1322000,61,1718000,-5,-396000,Marion County,Marion County-Clatsop County-OR
1115,Marion County-Columbia County-OR-1617,"Columbia County, OR",1617,2016,2017,69,1893000,66,1341000,3,552000,Marion County,Marion County-Columbia County-OR
1116,Marion County-Tillamook County-OR-1617,"Tillamook County, OR",1617,2016,2017,58,1001000,70,2236000,-12,-1235000,Marion County,Marion County-Tillamook County-OR
1117,Marion County-Cowlitz County-WA-1617,"Cowlitz County, WA",1617,2016,2017,47,1106000,48,733000,-1,373000,Marion County,Marion County-Cowlitz County-WA
1118,Marion County-Salt Lake County-UT-1617,"Salt Lake County, UT",1617,2016,2017,42,1234000,38,835000,4,399000,Marion County,Marion County-Salt Lake County-UT
1119,Marion County-Harris County-TX-1617,"Harris County, TX",1617,2016,2017,47,1429000,57,1201000,-10,228000,Marion County,Marion County-Harris County-TX
1120,Marion County-Canyon County-ID-1617,"Canyon County, ID",1617,2016,2017,44,698000,48,823000,-4,-125000,Marion County,Marion County-Canyon County-ID
1122,Morrow County-Umatilla County-OR-1617,"Umatilla County, OR",1617,2016,2017,305,5721000,382,6768000,-77,-1047000,Morrow County,Morrow County-Umatilla County-OR
1123,Morrow County-Benton County-WA-1617,"Benton County, WA",1617,2016,2017,48,1017000,71,1554000,-23,-537000,Morrow County,Morrow County-Benton County-WA
1125,Multnomah County-Washington County-OR-1617,"Washington County, OR",1617,2016,2017,8355,388877000,9957,418787000,-1602,-29910000,Multnomah County,Multnomah County-Washington County-OR
1126,Multnomah County-Clackamas County-OR-1617,"Clackamas County, OR",1617,2016,2017,7811,276742000,13814,520879000,-6003,-244137000,Multnomah County,Multnomah County-Clackamas County-OR
1127,Multnomah County-Clark County-WA-1617,"Clark County, WA",1617,2016,2017,3316,96453000,7324,237491000,-4008,-141038000,Multnomah County,Multnomah County-Clark County-WA
1128,Multnomah County-Los Angeles County-CA-1617,"Los Angeles County, CA",1617,2016,2017,1693,85379000,988,51507000,705,33872000,Multnomah County,Multnomah County-Los Angeles County-CA
1129,Multnomah County-King County-WA-1617,"King County, WA",1617,2016,2017,1468,71934000,1526,78304000,-58,-6370000,Multnomah County,Multnomah County-King County-WA
1130,Multnomah County-Lane County-OR-1617,"Lane County, OR",1617,2016,2017,1101,34347000,918,31928000,183,2419000,Multnomah County,Multnomah County-Lane County-OR
1131,Multnomah County-San Francisco County-CA-1617,"San Francisco County, CA",1617,2016,2017,1028,87992000,298,21848000,730,66144000,Multnomah County,Multnomah County-San Francisco County-CA
1132,Multnomah County-Marion County-OR-1617,"Marion County, OR",1617,2016,2017,966,29973000,1493,41700000,-527,-11727000,Multnomah County,Multnomah County-Marion County-OR
1133,Multnomah County-Alameda County-CA-1617,"Alameda County, CA",1617,2016,2017,880,55988000,288,16333000,592,39655000,Multnomah County,Multnomah County-Alameda County-CA
1134,Multnomah County-Cook County-IL-1617,"Cook County, IL",1617,2016,2017,740,42504000,278,12727000,462,29777000,Multnomah County,Multnomah County-Cook County-IL
1135,Multnomah County-San Diego County-CA-1617,"San Diego County, CA",1617,2016,2017,765,31816000,570,22148000,195,9668000,Multnomah County,Multnomah County-San Diego County-CA
1136,Multnomah County-Maricopa County-AZ-1617,"Maricopa County, AZ",1617,2016,2017,733,30994000,763,28896000,-30,2098000,Multnomah County,Multnomah County-Maricopa County-AZ
1137,Multnomah County-Orange County-CA-1617,"Orange County, CA",1617,2016,2017,635,32037000,243,11538000,392,20499000,Multnomah County,Multnomah County-Orange County-CA
1138,Multnomah County-Santa Clara County-CA-1617,"Santa Clara County, CA",1617,2016,2017,613,50885000,249,22764000,364,28121000,Multnomah County,Multnomah County-Santa Clara County-CA
1139,Multnomah County-Kings County-NY-1617,"Kings County, NY",1617,2016,2017,492,32353000,302,14827000,190,17526000,Multnomah County,Multnomah County-Kings County-NY
1140,Multnomah County-Benton County-OR-1617,"Benton County, OR",1617,2016,2017,463,13932000,342,10530000,121,3402000,Multnomah County,Multnomah County-Benton County-OR
1141,Multnomah County-Deschutes County-OR-1617,"Deschutes County, OR",1617,2016,2017,421,14119000,1175,57662000,-754,-43543000,Multnomah County,Multnomah County-Deschutes County-OR
1142,Multnomah County-Clark County-NV-1617,"Clark County, NV",1617,2016,2017,400,9619000,432,11924000,-32,-2305000,Multnomah County,Multnomah County-Clark County-NV
1143,Multnomah County-Travis County-TX-1617,"Travis County, TX",1617,2016,2017,337,16077000,241,11894000,96,4183000,Multnomah County,Multnomah County-Travis County-TX
1144,Multnomah County-New York County-NY-1617,"New York County, NY",1617,2016,2017,327,30888000,147,11004000,180,19884000,Multnomah County,Multnomah County-New York County-NY
1145,Multnomah County-Yamhill County-OR-1617,"Yamhill County, OR",1617,2016,2017,359,10692000,572,21041000,-213,-10349000,Multnomah County,Multnomah County-Yamhill County-OR
1146,Multnomah County-Jackson County-OR-1617,"Jackson County, OR",1617,2016,2017,313,12024000,401,12186000,-88,-162000,Multnomah County,Multnomah County-Jackson County-OR
1147,Multnomah County-Denver County-CO-1617,"Denver County, CO",1617,2016,2017,286,13313000,224,11046000,62,2267000,Multnomah County,Multnomah County-Denver County-CO
1148,Multnomah County-San Mateo County-CA-1617,"San Mateo County, CA",1617,2016,2017,343,27969000,106,7015000,237,20954000,Multnomah County,Multnomah County-San Mateo County-CA
1149,Multnomah County-Contra Costa County-CA-1617,"Contra Costa County, CA",1617,2016,2017,305,11459000,108,6729000,197,4730000,Multnomah County,Multnomah County-Contra Costa County-CA
1150,Multnomah County-Honolulu County-HI-1617,"Honolulu County, HI",1617,2016,2017,287,12093000,157,6818000,130,5275000,Multnomah County,Multnomah County-Honolulu County-HI
1151,Multnomah County-Sacramento County-CA-1617,"Sacramento County, CA",1617,2016,2017,312,11387000,237,7077000,75,4310000,Multnomah County,Multnomah County-Sacramento County-CA
1152,Multnomah County-Columbia County-OR-1617,"Columbia County, OR",1617,2016,2017,290,8997000,980,30573000,-690,-21576000,Multnomah County,Multnomah County-Columbia County-OR
1153,Multnomah County-Salt Lake County-UT-1617,"Salt Lake County, UT",1617,2016,2017,293,11461000,226,8312000,67,3149000,Multnomah County,Multnomah County-Salt Lake County-UT
1154,Multnomah County-Pierce County-WA-1617,"Pierce County, WA",1617,2016,2017,285,10962000,388,11780000,-103,-818000,Multnomah County,Multnomah County-Pierce County-WA
1155,Multnomah County-Hennepin County-MN-1617,"Hennepin County, MN",1617,2016,2017,228,10037000,222,8404000,6,1633000,Multnomah County,Multnomah County-Hennepin County-MN
1156,Multnomah County-District of Columbia-DC-1617,"District of Columbia, DC",1617,2016,2017,215,14700000,99,4650000,116,10050000,Multnomah County,Multnomah County-District of Columbia-DC
1157,Multnomah County-Middlesex County-MA-1617,"Middlesex County, MA",1617,2016,2017,222,15292000,140,7308000,82,7984000,Multnomah County,Multnomah County-Middlesex County-MA
1158,Multnomah County-Spokane County-WA-1617,"Spokane County, WA",1617,2016,2017,213,5849000,300,9209000,-87,-3360000,Multnomah County,Multnomah County-Spokane County-WA
1159,Multnomah County-Harris County-TX-1617,"Harris County, TX",1617,2016,2017,222,12253000,156,4661000,66,7592000,Multnomah County,Multnomah County-Harris County-TX
1160,Multnomah County-San Bernardino County-CA-1617,"San Bernardino County, CA",1617,2016,2017,228,7088000,73,2414000,155,4674000,Multnomah County,Multnomah County-San Bernardino County-CA
1161,Multnomah County-Ada County-ID-1617,"Ada County, ID",1617,2016,2017,201,6027000,369,11868000,-168,-5841000,Multnomah County,Multnomah County-Ada County-ID
1162,Multnomah County-Dallas County-TX-1617,"Dallas County, TX",1617,2016,2017,200,12880000,98,4977000,102,7903000,Multnomah County,Multnomah County-Dallas County-TX
1163,Multnomah County-Anchorage Municipality-AK-1617,"Anchorage Municipality, AK",1617,2016,2017,200,7297000,97,3446000,103,3851000,Multnomah County,Multnomah County-Anchorage Municipality-AK
1164,Multnomah County-Sonoma County-CA-1617,"Sonoma County, CA",1617,2016,2017,182,7179000,109,3135000,73,4044000,Multnomah County,Multnomah County-Sonoma County-CA
1165,Multnomah County-Pima County-AZ-1617,"Pima County, AZ",1617,2016,2017,217,5558000,218,8884000,-1,-3326000,Multnomah County,Multnomah County-Pima County-AZ
1166,Multnomah County-Polk County-OR-1617,"Polk County, OR",1617,2016,2017,206,6393000,277,7210000,-71,-817000,Multnomah County,Multnomah County-Polk County-OR
1167,Multnomah County-Riverside County-CA-1617,"Riverside County, CA",1617,2016,2017,183,4692000,188,7671000,-5,-2979000,Multnomah County,Multnomah County-Riverside County-CA
1168,Multnomah County-Suffolk County-MA-1617,"Suffolk County, MA",1617,2016,2017,148,10323000,82,6898000,66,3425000,Multnomah County,Multnomah County-Suffolk County-MA
1169,Multnomah County-Linn County-OR-1617,"Linn County, OR",1617,2016,2017,158,4243000,247,6574000,-89,-2331000,Multnomah County,Multnomah County-Linn County-OR
1170,Multnomah County-Santa Barbara County-CA-1617,"Santa Barbara County, CA",1617,2016,2017,153,6502000,79,5225000,74,1277000,Multnomah County,Multnomah County-Santa Barbara County-CA
1171,Multnomah County-Snohomish County-WA-1617,"Snohomish County, WA",1617,2016,2017,169,4989000,213,7261000,-44,-2272000,Multnomah County,Multnomah County-Snohomish County-WA
1172,Multnomah County-Thurston County-WA-1617,"Thurston County, WA",1617,2016,2017,155,5136000,208,7467000,-53,-2331000,Multnomah County,Multnomah County-Thurston County-WA
1173,Multnomah County-Cowlitz County-WA-1617,"Cowlitz County, WA",1617,2016,2017,178,5985000,444,10047000,-266,-4062000,Multnomah County,Multnomah County-Cowlitz County-WA
1174,Multnomah County-Ventura County-CA-1617,"Ventura County, CA",1617,2016,2017,170,6355000,77,2054000,93,4301000,Multnomah County,Multnomah County-Ventura County-CA
1175,Multnomah County-Philadelphia County-PA-1617,"Philadelphia County, PA",1617,2016,2017,129,6449000,113,4445000,16,2004000,Multnomah County,Multnomah County-Philadelphia County-PA
1176,Multnomah County-Hood River County-OR-1617,"Hood River County, OR",1617,2016,2017,148,6146000,300,13095000,-152,-6949000,Multnomah County,Multnomah County-Hood River County-OR
1177,Multnomah County-Marin County-CA-1617,"Marin County, CA",1617,2016,2017,145,9063000,76,3514000,69,5549000,Multnomah County,Multnomah County-Marin County-CA
1178,Multnomah County-Santa Cruz County-CA-1617,"Santa Cruz County, CA",1617,2016,2017,131,5686000,63,2749000,68,2937000,Multnomah County,Multnomah County-Santa Cruz County-CA
1179,Multnomah County-Lincoln County-OR-1617,"Lincoln County, OR",1617,2016,2017,133,4354000,283,8749000,-150,-4395000,Multnomah County,Multnomah County-Lincoln County-OR
1180,Multnomah County-Clatsop County-OR-1617,"Clatsop County, OR",1617,2016,2017,141,4290000,346,11752000,-205,-7462000,Multnomah County,Multnomah County-Clatsop County-OR
1181,Multnomah County-Boulder County-CO-1617,"Boulder County, CO",1617,2016,2017,106,3970000,121,4682000,-15,-712000,Multnomah County,Multnomah County-Boulder County-CO
1182,Multnomah County-Whatcom County-WA-1617,"Whatcom County, WA",1617,2016,2017,120,3703000,140,4806000,-20,-1103000,Multnomah County,Multnomah County-Whatcom County-WA
1183,Multnomah County-Washoe County-NV-1617,"Washoe County, NV",1617,2016,2017,132,5782000,120,3260000,12,2522000,Multnomah County,Multnomah County-Washoe County-NV
1184,Multnomah County-Bernalillo County-NM-1617,"Bernalillo County, NM",1617,2016,2017,125,4592000,99,2903000,26,1689000,Multnomah County,Multnomah County-Bernalillo County-NM
1185,Multnomah County-Franklin County-OH-1617,"Franklin County, OH",1617,2016,2017,123,6132000,97,2765000,26,3367000,Multnomah County,Multnomah County-Franklin County-OH
1186,Multnomah County-Milwaukee County-WI-1617,"Milwaukee County, WI",1617,2016,2017,112,3866000,55,1797000,57,2069000,Multnomah County,Multnomah County-Milwaukee County-WI
1187,Multnomah County-Queens County-NY-1617,"Queens County, NY",1617,2016,2017,105,4714000,30,1256000,75,3458000,Multnomah County,Multnomah County-Queens County-NY
1188,Multnomah County-Fulton County-GA-1617,"Fulton County, GA",1617,2016,2017,108,5876000,75,5116000,33,760000,Multnomah County,Multnomah County-Fulton County-GA
1189,Multnomah County-Dane County-WI-1617,"Dane County, WI",1617,2016,2017,100,5780000,90,2883000,10,2897000,Multnomah County,Multnomah County-Dane County-WI
1190,Multnomah County-Jefferson County-CO-1617,"Jefferson County, CO",1617,2016,2017,109,4275000,87,3625000,22,650000,Multnomah County,Multnomah County-Jefferson County-CO
1191,Multnomah County-Miami-Dade County-FL-1617,"Miami-Dade County, FL",1617,2016,2017,97,3301000,75,3566000,22,-265000,Multnomah County,Multnomah County-Miami-Dade County-FL
1192,Multnomah County-Allegheny County-PA-1617,"Allegheny County, PA",1617,2016,2017,107,4925000,88,5007000,19,-82000,Multnomah County,Multnomah County-Allegheny County-PA
1193,Multnomah County-Orange County-FL-1617,"Orange County, FL",1617,2016,2017,93,4302000,66,1778000,27,2524000,Multnomah County,Multnomah County-Orange County-FL
1194,Multnomah County-Missoula County-MT-1617,"Missoula County, MT",1617,2016,2017,93,2358000,76,2666000,17,-308000,Multnomah County,Multnomah County-Missoula County-MT
1195,Multnomah County-Marion County-IN-1617,"Marion County, IN",1617,2016,2017,95,4084000,45,1358000,50,2726000,Multnomah County,Multnomah County-Marion County-IN
1196,Multnomah County-Douglas County-OR-1617,"Douglas County, OR",1617,2016,2017,105,3767000,168,4781000,-63,-1014000,Multnomah County,Multnomah County-Douglas County-OR
1197,Multnomah County-Tillamook County-OR-1617,"Tillamook County, OR",1617,2016,2017,105,2745000,248,11400000,-143,-8655000,Multnomah County,Multnomah County-Tillamook County-OR
1198,Multnomah County-Davidson County-TN-1617,"Davidson County, TN",1617,2016,2017,94,4329000,86,2780000,8,1549000,Multnomah County,Multnomah County-Davidson County-TN
1199,Multnomah County-Humboldt County-CA-1617,"Humboldt County, CA",1617,2016,2017,81,2838000,47,1007000,34,1831000,Multnomah County,Multnomah County-Humboldt County-CA
1200,Multnomah County-Fairfax County-VA-1617,"Fairfax County, VA",1617,2016,2017,102,6943000,52,2098000,50,4845000,Multnomah County,Multnomah County-Fairfax County-VA
1201,Multnomah County-Fresno County-CA-1617,"Fresno County, CA",1617,2016,2017,98,3495000,44,998000,54,2497000,Multnomah County,Multnomah County-Fresno County-CA
1202,Multnomah County-San Luis Obispo County-CA-1617,"San Luis Obispo County, CA",1617,2016,2017,85,2706000,53,1598000,32,1108000,Multnomah County,Multnomah County-San Luis Obispo County-CA
1203,Multnomah County-Kitsap County-WA-1617,"Kitsap County, WA",1617,2016,2017,94,3240000,149,4449000,-55,-1209000,Multnomah County,Multnomah County-Kitsap County-WA
1204,Multnomah County-Arapahoe County-CO-1617,"Arapahoe County, CO",1617,2016,2017,97,3943000,64,2301000,33,1642000,Multnomah County,Multnomah County-Arapahoe County-CO
1205,Multnomah County-Cuyahoga County-OH-1617,"Cuyahoga County, OH",1617,2016,2017,89,2599000,66,1907000,23,692000,Multnomah County,Multnomah County-Cuyahoga County-OH
1206,Multnomah County-Broward County-FL-1617,"Broward County, FL",1617,2016,2017,83,4646000,50,2367000,33,2279000,Multnomah County,Multnomah County-Broward County-FL
1207,Multnomah County-Montgomery County-MD-1617,"Montgomery County, MD",1617,2016,2017,95,4893000,50,1800000,45,3093000,Multnomah County,Multnomah County-Montgomery County-MD
1208,Multnomah County-Wake County-NC-1617,"Wake County, NC",1617,2016,2017,99,3563000,56,2721000,43,842000,Multnomah County,Multnomah County-Wake County-NC
1209,Multnomah County-Benton County-WA-1617,"Benton County, WA",1617,2016,2017,82,3368000,153,4964000,-71,-1596000,Multnomah County,Multnomah County-Benton County-WA
1210,Multnomah County-Palm Beach County-FL-1617,"Palm Beach County, FL",1617,2016,2017,80,2873000,55,1964000,25,909000,Multnomah County,Multnomah County-Palm Beach County-FL
1211,Multnomah County-Oakland County-MI-1617,"Oakland County, MI",1617,2016,2017,72,3473000,63,2780000,9,693000,Multnomah County,Multnomah County-Oakland County-MI
1212,Multnomah County-Hillsborough County-FL-1617,"Hillsborough County, FL",1617,2016,2017,79,2474000,50,1419000,29,1055000,Multnomah County,Multnomah County-Hillsborough County-FL
1213,Multnomah County-Ramsey County-MN-1617,"Ramsey County, MN",1617,2016,2017,79,2883000,67,1933000,12,950000,Multnomah County,Multnomah County-Ramsey County-MN
1214,Multnomah County-Baltimore city-MD-1617,"Baltimore city, MD",1617,2016,2017,85,4212000,57,2739000,28,1473000,Multnomah County,Multnomah County-Baltimore city-MD
1215,Multnomah County-Washtenaw County-MI-1617,"Washtenaw County, MI",1617,2016,2017,87,4278000,61,2403000,26,1875000,Multnomah County,Multnomah County-Washtenaw County-MI
1216,Multnomah County-St. Louis city-MO-1617,"St. Louis city, MO",1617,2016,2017,69,2690000,36,1503000,33,1187000,Multnomah County,Multnomah County-St. Louis city-MO
1217,Multnomah County-Larimer County-CO-1617,"Larimer County, CO",1617,2016,2017,76,3224000,82,2838000,-6,386000,Multnomah County,Multnomah County-Larimer County-CO
1218,Multnomah County-Josephine County-OR-1617,"Josephine County, OR",1617,2016,2017,90,1674000,124,2984000,-34,-1310000,Multnomah County,Multnomah County-Josephine County-OR
1219,Multnomah County-Maui County-HI-1617,"Maui County, HI",1617,2016,2017,79,2634000,62,2417000,17,217000,Multnomah County,Multnomah County-Maui County-HI
1220,Multnomah County-Norfolk County-MA-1617,"Norfolk County, MA",1617,2016,2017,74,5075000,35,3706000,39,1369000,Multnomah County,Multnomah County-Norfolk County-MA
1221,Multnomah County-Mecklenburg County-NC-1617,"Mecklenburg County, NC",1617,2016,2017,68,3226000,61,1923000,7,1303000,Multnomah County,Multnomah County-Mecklenburg County-NC
1222,Multnomah County-Wasco County-OR-1617,"Wasco County, OR",1617,2016,2017,84,2093000,196,6199000,-112,-4106000,Multnomah County,Multnomah County-Wasco County-OR
1223,Multnomah County-Arlington County-VA-1617,"Arlington County, VA",1617,2016,2017,73,5175000,32,2204000,41,2971000,Multnomah County,Multnomah County-Arlington County-VA
1224,Multnomah County-Monterey County-CA-1617,"Monterey County, CA",1617,2016,2017,70,3670000,57,2364000,13,1306000,Multnomah County,Multnomah County-Monterey County-CA
1225,Multnomah County-Yakima County-WA-1617,"Yakima County, WA",1617,2016,2017,85,1979000,82,2057000,3,-78000,Multnomah County,Multnomah County-Yakima County-WA
1226,Multnomah County-Kern County-CA-1617,"Kern County, CA",1617,2016,2017,82,2174000,44,1232000,38,942000,Multnomah County,Multnomah County-Kern County-CA
1227,Multnomah County-DeKalb County-GA-1617,"DeKalb County, GA",1617,2016,2017,76,3014000,70,3101000,6,-87000,Multnomah County,Multnomah County-DeKalb County-GA
1228,Multnomah County-St. Louis County-MO-1617,"St. Louis County, MO",1617,2016,2017,74,2206000,40,1530000,34,676000,Multnomah County,Multnomah County-St. Louis County-MO
1229,Multnomah County-Gallatin County-MT-1617,"Gallatin County, MT",1617,2016,2017,59,1614000,65,1690000,-6,-76000,Multnomah County,Multnomah County-Gallatin County-MT
1230,Multnomah County-Hamilton County-OH-1617,"Hamilton County, OH",1617,2016,2017,60,3726000,49,1392000,11,2334000,Multnomah County,Multnomah County-Hamilton County-OH
1231,Multnomah County-El Paso County-CO-1617,"El Paso County, CO",1617,2016,2017,78,3298000,95,2349000,-17,949000,Multnomah County,Multnomah County-El Paso County-CO
1232,Multnomah County-San Joaquin County-CA-1617,"San Joaquin County, CA",1617,2016,2017,83,2303000,38,585000,45,1718000,Multnomah County,Multnomah County-San Joaquin County-CA
1233,Multnomah County-Hawaii County-HI-1617,"Hawaii County, HI",1617,2016,2017,67,1620000,103,2989000,-36,-1369000,Multnomah County,Multnomah County-Hawaii County-HI
1234,Multnomah County-Orleans Parish-LA-1617,"Orleans Parish, LA",1617,2016,2017,59,2399000,84,2451000,-25,-52000,Multnomah County,Multnomah County-Orleans Parish-LA
1235,Multnomah County-Klamath County-OR-1617,"Klamath County, OR",1617,2016,2017,68,1819000,105,2512000,-37,-693000,Multnomah County,Multnomah County-Klamath County-OR
1236,Multnomah County-Bexar County-TX-1617,"Bexar County, TX",1617,2016,2017,64,2411000,66,1778000,-2,633000,Multnomah County,Multnomah County-Bexar County-TX
1237,Multnomah County-Placer County-CA-1617,"Placer County, CA",1617,2016,2017,59,2329000,66,2449000,-7,-120000,Multnomah County,Multnomah County-Placer County-CA
1238,Multnomah County-Shasta County-CA-1617,"Shasta County, CA",1617,2016,2017,62,1890000,54,2108000,8,-218000,Multnomah County,Multnomah County-Shasta County-CA
1239,Multnomah County-Pinellas County-FL-1617,"Pinellas County, FL",1617,2016,2017,54,2764000,85,3043000,-31,-279000,Multnomah County,Multnomah County-Pinellas County-FL
1240,Multnomah County-Tarrant County-TX-1617,"Tarrant County, TX",1617,2016,2017,74,2389000,91,2315000,-17,74000,Multnomah County,Multnomah County-Tarrant County-TX
1241,Multnomah County-Umatilla County-OR-1617,"Umatilla County, OR",1617,2016,2017,71,1758000,141,3006000,-70,-1248000,Multnomah County,Multnomah County-Umatilla County-OR
1242,Multnomah County-Coconino County-AZ-1617,"Coconino County, AZ",1617,2016,2017,59,1541000,31,784000,28,757000,Multnomah County,Multnomah County-Coconino County-AZ
1243,Multnomah County-Douglas County-NE-1617,"Douglas County, NE",1617,2016,2017,55,2798000,63,2133000,-8,665000,Multnomah County,Multnomah County-Douglas County-NE
1244,Multnomah County-Buncombe County-NC-1617,"Buncombe County, NC",1617,2016,2017,53,1514000,57,2265000,-4,-751000,Multnomah County,Multnomah County-Buncombe County-NC
1245,Multnomah County-New Haven County-CT-1617,"New Haven County, CT",1617,2016,2017,62,2601000,58,2049000,4,552000,Multnomah County,Multnomah County-New Haven County-CT
1246,Multnomah County-Butte County-CA-1617,"Butte County, CA",1617,2016,2017,54,1840000,69,1609000,-15,231000,Multnomah County,Multnomah County-Butte County-CA
1247,Multnomah County-Yolo County-CA-1617,"Yolo County, CA",1617,2016,2017,60,1848000,36,1279000,24,569000,Multnomah County,Multnomah County-Yolo County-CA
1248,Multnomah County-Coos County-OR-1617,"Coos County, OR",1617,2016,2017,58,1457000,117,2794000,-59,-1337000,Multnomah County,Multnomah County-Coos County-OR
1249,Multnomah County-Charleston County-SC-1617,"Charleston County, SC",1617,2016,2017,58,2590000,30,1190000,28,1400000,Multnomah County,Multnomah County-Charleston County-SC
1250,Multnomah County-Walla Walla County-WA-1617,"Walla Walla County, WA",1617,2016,2017,58,1548000,68,2019000,-10,-471000,Multnomah County,Multnomah County-Walla Walla County-WA
1251,Multnomah County-Duval County-FL-1617,"Duval County, FL",1617,2016,2017,59,1689000,67,2365000,-8,-676000,Multnomah County,Multnomah County-Duval County-FL
1252,Multnomah County-Kent County-MI-1617,"Kent County, MI",1617,2016,2017,45,2224000,44,1589000,1,635000,Multnomah County,Multnomah County-Kent County-MI
1253,Multnomah County-Hudson County-NJ-1617,"Hudson County, NJ",1617,2016,2017,56,3543000,36,1746000,20,1797000,Multnomah County,Multnomah County-Hudson County-NJ
1254,Multnomah County-Johnson County-KS-1617,"Johnson County, KS",1617,2016,2017,52,2203000,56,2364000,-4,-161000,Multnomah County,Multnomah County-Johnson County-KS
1255,Multnomah County-Santa Fe County-NM-1617,"Santa Fe County, NM",1617,2016,2017,51,2545000,64,2423000,-13,122000,Multnomah County,Multnomah County-Santa Fe County-NM
1256,Multnomah County-Monroe County-NY-1617,"Monroe County, NY",1617,2016,2017,46,1782000,50,1660000,-4,122000,Multnomah County,Multnomah County-Monroe County-NY
1257,Multnomah County-Chittenden County-VT-1617,"Chittenden County, VT",1617,2016,2017,54,2105000,48,1414000,6,691000,Multnomah County,Multnomah County-Chittenden County-VT
1258,Multnomah County-Yavapai County-AZ-1617,"Yavapai County, AZ",1617,2016,2017,47,1347000,57,2134000,-10,-787000,Multnomah County,Multnomah County-Yavapai County-AZ
1259,Multnomah County-Kootenai County-ID-1617,"Kootenai County, ID",1617,2016,2017,54,1591000,88,2633000,-34,-1042000,Multnomah County,Multnomah County-Kootenai County-ID
1260,Multnomah County-DuPage County-IL-1617,"DuPage County, IL",1617,2016,2017,37,1413000,37,1608000,0,-195000,Multnomah County,Multnomah County-DuPage County-IL
1261,Multnomah County-Jackson County-MO-1617,"Jackson County, MO",1617,2016,2017,47,1600000,57,1876000,-10,-276000,Multnomah County,Multnomah County-Jackson County-MO
1262,Multnomah County-Providence County-RI-1617,"Providence County, RI",1617,2016,2017,48,2337000,53,2073000,-5,264000,Multnomah County,Multnomah County-Providence County-RI
1263,Multnomah County-Solano County-CA-1617,"Solano County, CA",1617,2016,2017,53,1995000,46,1011000,7,984000,Multnomah County,Multnomah County-Solano County-CA
1264,Multnomah County-Hartford County-CT-1617,"Hartford County, CT",1617,2016,2017,41,2121000,27,387000,14,1734000,Multnomah County,Multnomah County-Hartford County-CT
1265,Multnomah County-Cumberland County-ME-1617,"Cumberland County, ME",1617,2016,2017,44,3210000,66,2386000,-22,824000,Multnomah County,Multnomah County-Cumberland County-ME
1266,Multnomah County-Utah County-UT-1617,"Utah County, UT",1617,2016,2017,69,1058000,49,1131000,20,-73000,Multnomah County,Multnomah County-Utah County-UT
1267,Multnomah County-Canyon County-ID-1617,"Canyon County, ID",1617,2016,2017,60,1012000,168,3258000,-108,-2246000,Multnomah County,Multnomah County-Canyon County-ID
1268,Multnomah County-Oklahoma County-OK-1617,"Oklahoma County, OK",1617,2016,2017,53,1391000,35,1301000,18,90000,Multnomah County,Multnomah County-Oklahoma County-OK
1269,Multnomah County-Wayne County-MI-1617,"Wayne County, MI",1617,2016,2017,40,2419000,55,1621000,-15,798000,Multnomah County,Multnomah County-Wayne County-MI
1270,Multnomah County-Union County-OR-1617,"Union County, OR",1617,2016,2017,45,1080000,47,1942000,-2,-862000,Multnomah County,Multnomah County-Union County-OR
1271,Multnomah County-Greene County-MO-1617,"Greene County, MO",1617,2016,2017,32,867000,51,1092000,-19,-225000,Multnomah County,Multnomah County-Greene County-MO
1272,Multnomah County-Shelby County-TN-1617,"Shelby County, TN",1617,2016,2017,53,2121000,30,1030000,23,1091000,Multnomah County,Multnomah County-Shelby County-TN
1273,Multnomah County-Jefferson County-KY-1617,"Jefferson County, KY",1617,2016,2017,42,1845000,42,1639000,0,206000,Multnomah County,Multnomah County-Jefferson County-KY
1274,Multnomah County-Hampshire County-MA-1617,"Hampshire County, MA",1617,2016,2017,42,1356000,42,2205000,0,-849000,Multnomah County,Multnomah County-Hampshire County-MA
1275,Multnomah County-Erie County-NY-1617,"Erie County, NY",1617,2016,2017,34,1168000,33,800000,1,368000,Multnomah County,Multnomah County-Erie County-NY
1276,Multnomah County-Collin County-TX-1617,"Collin County, TX",1617,2016,2017,45,2230000,49,2937000,-4,-707000,Multnomah County,Multnomah County-Collin County-TX
1277,Multnomah County-Williamson County-TX-1617,"Williamson County, TX",1617,2016,2017,48,1599000,59,3078000,-11,-1479000,Multnomah County,Multnomah County-Williamson County-TX
1278,Multnomah County-Durham County-NC-1617,"Durham County, NC",1617,2016,2017,42,1781000,54,2344000,-12,-563000,Multnomah County,Multnomah County-Durham County-NC
1279,Multnomah County-Orange County-NC-1617,"Orange County, NC",1617,2016,2017,47,2160000,38,1367000,9,793000,Multnomah County,Multnomah County-Orange County-NC
1280,Multnomah County-Klickitat County-WA-1617,"Klickitat County, WA",1617,2016,2017,46,1471000,124,5017000,-78,-3546000,Multnomah County,Multnomah County-Klickitat County-WA
1281,Multnomah County-Onondaga County-NY-1617,"Onondaga County, NY",1617,2016,2017,34,1369000,29,1096000,5,273000,Multnomah County,Multnomah County-Onondaga County-NY
1282,Multnomah County-Polk County-IA-1617,"Polk County, IA",1617,2016,2017,38,1222000,49,1182000,-11,40000,Multnomah County,Multnomah County-Polk County-IA
1283,Multnomah County-Island County-WA-1617,"Island County, WA",1617,2016,2017,35,974000,52,1120000,-17,-146000,Multnomah County,Multnomah County-Island County-WA
1284,Multnomah County-Jefferson County-OR-1617,"Jefferson County, OR",1617,2016,2017,35,1473000,78,2191000,-43,-718000,Multnomah County,Multnomah County-Jefferson County-OR
1286,Polk County-Marion County-OR-1617,"Marion County, OR",1617,2016,2017,3271,78321000,3058,79173000,213,-852000,Polk County,Polk County-Marion County-OR
1287,Polk County-Yamhill County-OR-1617,"Yamhill County, OR",1617,2016,2017,679,15604000,409,8501000,270,7103000,Polk County,Polk County-Yamhill County-OR
1288,Polk County-Washington County-OR-1617,"Washington County, OR",1617,2016,2017,408,10729000,248,7320000,160,3409000,Polk County,Polk County-Washington County-OR
1289,Polk County-Multnomah County-OR-1617,"Multnomah County, OR",1617,2016,2017,277,7210000,206,6393000,71,817000,Polk County,Polk County-Multnomah County-OR
1290,Polk County-Clackamas County-OR-1617,"Clackamas County, OR",1617,2016,2017,280,7636000,178,5069000,102,2567000,Polk County,Polk County-Clackamas County-OR
1291,Polk County-Linn County-OR-1617,"Linn County, OR",1617,2016,2017,265,6540000,317,7410000,-52,-870000,Polk County,Polk County-Linn County-OR
1292,Polk County-Benton County-OR-1617,"Benton County, OR",1617,2016,2017,212,6008000,142,3666000,70,2342000,Polk County,Polk County-Benton County-OR
1293,Polk County-Lane County-OR-1617,"Lane County, OR",1617,2016,2017,156,4021000,142,3541000,14,480000,Polk County,Polk County-Lane County-OR
1294,Polk County-Deschutes County-OR-1617,"Deschutes County, OR",1617,2016,2017,107,3119000,160,4535000,-53,-1416000,Polk County,Polk County-Deschutes County-OR
1295,Polk County-Lincoln County-OR-1617,"Lincoln County, OR",1617,2016,2017,101,2418000,115,2910000,-14,-492000,Polk County,Polk County-Lincoln County-OR
1296,Polk County-Clark County-WA-1617,"Clark County, WA",1617,2016,2017,70,1561000,82,2647000,-12,-1086000,Polk County,Polk County-Clark County-WA
1297,Polk County-Maricopa County-AZ-1617,"Maricopa County, AZ",1617,2016,2017,67,2358000,68,1684000,-1,674000,Polk County,Polk County-Maricopa County-AZ
1298,Polk County-Douglas County-OR-1617,"Douglas County, OR",1617,2016,2017,81,1725000,43,851000,38,874000,Polk County,Polk County-Douglas County-OR
1299,Polk County-Jackson County-OR-1617,"Jackson County, OR",1617,2016,2017,64,1688000,43,927000,21,761000,Polk County,Polk County-Jackson County-OR
1300,Polk County-King County-WA-1617,"King County, WA",1617,2016,2017,63,1951000,40,1680000,23,271000,Polk County,Polk County-King County-WA
1303,Tillamook County-Multnomah County-OR-1617,"Multnomah County, OR",1617,2016,2017,248,11400000,105,2745000,143,8655000,Tillamook County,Tillamook County-Multnomah County-OR
1304,Tillamook County-Washington County-OR-1617,"Washington County, OR",1617,2016,2017,246,8137000,107,3240000,139,4897000,Tillamook County,Tillamook County-Washington County-OR
1305,Tillamook County-Clackamas County-OR-1617,"Clackamas County, OR",1617,2016,2017,126,5250000,62,2337000,64,2913000,Tillamook County,Tillamook County-Clackamas County-OR
1306,Tillamook County-Clatsop County-OR-1617,"Clatsop County, OR",1617,2016,2017,83,1414000,78,2019000,5,-605000,Tillamook County,Tillamook County-Clatsop County-OR
1307,Tillamook County-Marion County-OR-1617,"Marion County, OR",1617,2016,2017,70,2236000,58,1001000,12,1235000,Tillamook County,Tillamook County-Marion County-OR
1308,Tillamook County-Yamhill County-OR-1617,"Yamhill County, OR",1617,2016,2017,77,1487000,47,1276000,30,211000,Tillamook County,Tillamook County-Yamhill County-OR
1309,Tillamook County-Lincoln County-OR-1617,"Lincoln County, OR",1617,2016,2017,47,1055000,70,1992000,-23,-937000,Tillamook County,Tillamook County-Lincoln County-OR
1310,Tillamook County-Deschutes County-OR-1617,"Deschutes County, OR",1617,2016,2017,52,1666000,59,1341000,-7,325000,Tillamook County,Tillamook County-Deschutes County-OR
1311,Tillamook County-Lane County-OR-1617,"Lane County, OR",1617,2016,2017,37,1081000,55,1147000,-18,-66000,Tillamook County,Tillamook County-Lane County-OR
1312,Tillamook County-Clark County-WA-1617,"Clark County, WA",1617,2016,2017,41,1553000,42,911000,-1,642000,Tillamook County,Tillamook County-Clark County-WA
1314,Umatilla County-Walla Walla County-WA-1617,"Walla Walla County, WA",1617,2016,2017,334,7106000,453,8809000,-119,-1703000,Umatilla County,Umatilla County-Walla Walla County-WA
1315,Umatilla County-Morrow County-OR-1617,"Morrow County, OR",1617,2016,2017,382,6768000,305,5721000,77,1047000,Umatilla County,Umatilla County-Morrow County-OR
1316,Umatilla County-Benton County-WA-1617,"Benton County, WA",1617,2016,2017,232,4215000,355,6943000,-123,-2728000,Umatilla County,Umatilla County-Benton County-WA
1317,Umatilla County-Multnomah County-OR-1617,"Multnomah County, OR",1617,2016,2017,141,3006000,71,1758000,70,1248000,Umatilla County,Umatilla County-Multnomah County-OR
1318,Umatilla County-Union County-OR-1617,"Union County, OR",1617,2016,2017,128,2886000,110,2057000,18,829000,Umatilla County,Umatilla County-Union County-OR
1319,Umatilla County-Washington County-OR-1617,"Washington County, OR",1617,2016,2017,105,2799000,73,2325000,32,474000,Umatilla County,Umatilla County-Washington County-OR
1320,Umatilla County-Marion County-OR-1617,"Marion County, OR",1617,2016,2017,108,2329000,88,2016000,20,313000,Umatilla County,Umatilla County-Marion County-OR
1321,Umatilla County-Clackamas County-OR-1617,"Clackamas County, OR",1617,2016,2017,79,1639000,73,2318000,6,-679000,Umatilla County,Umatilla County-Clackamas County-OR
1322,Umatilla County-Deschutes County-OR-1617,"Deschutes County, OR",1617,2016,2017,82,1575000,74,2762000,8,-1187000,Umatilla County,Umatilla County-Deschutes County-OR
1323,Umatilla County-Lane County-OR-1617,"Lane County, OR",1617,2016,2017,79,1342000,47,1180000,32,162000,Umatilla County,Umatilla County-Lane County-OR
1324,Umatilla County-Yakima County-WA-1617,"Yakima County, WA",1617,2016,2017,87,1143000,73,990000,14,153000,Umatilla County,Umatilla County-Yakima County-WA
1325,Umatilla County-Clark County-WA-1617,"Clark County, WA",1617,2016,2017,58,687000,41,680000,17,7000,Umatilla County,Umatilla County-Clark County-WA
1326,Umatilla County-Maricopa County-AZ-1617,"Maricopa County, AZ",1617,2016,2017,38,1235000,64,1804000,-26,-569000,Umatilla County,Umatilla County-Maricopa County-AZ
1327,Umatilla County-Franklin County-WA-1617,"Franklin County, WA",1617,2016,2017,65,1073000,139,2291000,-74,-1218000,Umatilla County,Umatilla County-Franklin County-WA
1328,Umatilla County-King County-WA-1617,"King County, WA",1617,2016,2017,39,1269000,40,965000,-1,304000,Umatilla County,Umatilla County-King County-WA
1329,Umatilla County-Linn County-OR-1617,"Linn County, OR",1617,2016,2017,39,999000,64,1425000,-25,-426000,Umatilla County,Umatilla County-Linn County-OR
1331,Union County-Umatilla County-OR-1617,"Umatilla County, OR",1617,2016,2017,110,2057000,128,2886000,-18,-829000,Union County,Union County-Umatilla County-OR
1332,Union County-Baker County-OR-1617,"Baker County, OR",1617,2016,2017,99,1466000,108,2374000,-9,-908000,Union County,Union County-Baker County-OR
1333,Union County-Multnomah County-OR-1617,"Multnomah County, OR",1617,2016,2017,47,1942000,45,1080000,2,862000,Union County,Union County-Multnomah County-OR
1334,Union County-Deschutes County-OR-1617,"Deschutes County, OR",1617,2016,2017,40,1159000,42,1129000,-2,30000,Union County,Union County-Deschutes County-OR
1335,Union County-Wallowa County-OR-1617,"Wallowa County, OR",1617,2016,2017,44,878000,56,1629000,-12,-751000,Union County,Union County-Wallowa County-OR
1336,Union County-Ada County-ID-1617,"Ada County, ID",1617,2016,2017,30,680000,58,1855000,-28,-1175000,Union County,Union County-Ada County-ID
1338,Wallowa County-Union County-OR-1617,"Union County, OR",1617,2016,2017,56,1629000,44,878000,12,751000,Wallowa County,Wallowa County-Union County-OR
1340,Wasco County-Hood River County-OR-1617,"Hood River County, OR",1617,2016,2017,362,8979000,191,3549000,171,5430000,Wasco County,Wasco County-Hood River County-OR
1341,Wasco County-Multnomah County-OR-1617,"Multnomah County, OR",1617,2016,2017,196,6199000,84,2093000,112,4106000,Wasco County,Wasco County-Multnomah County-OR
1342,Wasco County-Klickitat County-WA-1617,"Klickitat County, WA",1617,2016,2017,155,4816000,160,3937000,-5,879000,Wasco County,Wasco County-Klickitat County-WA
1343,Wasco County-Washington County-OR-1617,"Washington County, OR",1617,2016,2017,77,2863000,59,1865000,18,998000,Wasco County,Wasco County-Washington County-OR
1344,Wasco County-Clackamas County-OR-1617,"Clackamas County, OR",1617,2016,2017,82,2395000,68,1559000,14,836000,Wasco County,Wasco County-Clackamas County-OR
1345,Wasco County-Deschutes County-OR-1617,"Deschutes County, OR",1617,2016,2017,61,1534000,66,2009000,-5,-475000,Wasco County,Wasco County-Deschutes County-OR
1347,Washington County-Multnomah County-OR-1617,"Multnomah County, OR",1617,2016,2017,9957,418787000,8355,388877000,1602,29910000,Washington County,Washington County-Multnomah County-OR
1348,Washington County-Clackamas County-OR-1617,"Clackamas County, OR",1617,2016,2017,4385,181440000,5698,247004000,-1313,-65564000,Washington County,Washington County-Clackamas County-OR
1349,Washington County-Clark County-WA-1617,"Clark County, WA",1617,2016,2017,1668,44259000,2831,113265000,-1163,-69006000,Washington County,Washington County-Clark County-WA
1350,Washington County-Los Angeles County-CA-1617,"Los Angeles County, CA",1617,2016,2017,1071,40425000,475,15999000,596,24426000,Washington County,Washington County-Los Angeles County-CA
1351,Washington County-Yamhill County-OR-1617,"Yamhill County, OR",1617,2016,2017,1096,31828000,2719,90171000,-1623,-58343000,Washington County,Washington County-Yamhill County-OR
1352,Washington County-Marion County-OR-1617,"Marion County, OR",1617,2016,2017,1027,29767000,1868,48969000,-841,-19202000,Washington County,Washington County-Marion County-OR
1353,Washington County-King County-WA-1617,"King County, WA",1617,2016,2017,915,43414000,1077,59992000,-162,-16578000,Washington County,Washington County-King County-WA
1354,Washington County-Maricopa County-AZ-1617,"Maricopa County, AZ",1617,2016,2017,1045,37682000,1042,46765000,3,-9083000,Washington County,Washington County-Maricopa County-AZ
1355,Washington County-Lane County-OR-1617,"Lane County, OR",1617,2016,2017,665,20000000,608,19267000,57,733000,Washington County,Washington County-Lane County-OR
1356,Washington County-Santa Clara County-CA-1617,"Santa Clara County, CA",1617,2016,2017,920,55495000,629,47902000,291,7593000,Washington County,Washington County-Santa Clara County-CA
1357,Washington County-Orange County-CA-1617,"Orange County, CA",1617,2016,2017,712,26977000,301,11966000,411,15011000,Washington County,Washington County-Orange County-CA
1358,Washington County-San Diego County-CA-1617,"San Diego County, CA",1617,2016,2017,692,26667000,406,14139000,286,12528000,Washington County,Washington County-San Diego County-CA
1359,Washington County-Benton County-OR-1617,"Benton County, OR",1617,2016,2017,436,12159000,243,6925000,193,5234000,Washington County,Washington County-Benton County-OR
1360,Washington County-Columbia County-OR-1617,"Columbia County, OR",1617,2016,2017,477,13267000,1280,39843000,-803,-26576000,Washington County,Washington County-Columbia County-OR
1361,Washington County-Deschutes County-OR-1617,"Deschutes County, OR",1617,2016,2017,403,16782000,949,43055000,-546,-26273000,Washington County,Washington County-Deschutes County-OR
1362,Washington County-Clark County-NV-1617,"Clark County, NV",1617,2016,2017,424,14226000,352,10911000,72,3315000,Washington County,Washington County-Clark County-NV
1363,Washington County-Alameda County-CA-1617,"Alameda County, CA",1617,2016,2017,402,20296000,198,11927000,204,8369000,Washington County,Washington County-Alameda County-CA
1364,Washington County-Honolulu County-HI-1617,"Honolulu County, HI",1617,2016,2017,376,12756000,140,3745000,236,9011000,Washington County,Washington County-Honolulu County-HI
1365,Washington County-Riverside County-CA-1617,"Riverside County, CA",1617,2016,2017,310,8397000,192,6701000,118,1696000,Washington County,Washington County-Riverside County-CA
1366,Washington County-Jackson County-OR-1617,"Jackson County, OR",1617,2016,2017,259,7175000,310,7985000,-51,-810000,Washington County,Washington County-Jackson County-OR
1367,Washington County-Pierce County-WA-1617,"Pierce County, WA",1617,2016,2017,285,10974000,286,10931000,-1,43000,Washington County,Washington County-Pierce County-WA
1368,Washington County-Sacramento County-CA-1617,"Sacramento County, CA",1617,2016,2017,273,11502000,153,6555000,120,4947000,Washington County,Washington County-Sacramento County-CA
1369,Washington County-Polk County-OR-1617,"Polk County, OR",1617,2016,2017,248,7320000,408,10729000,-160,-3409000,Washington County,Washington County-Polk County-OR
1370,Washington County-Contra Costa County-CA-1617,"Contra Costa County, CA",1617,2016,2017,284,13124000,95,4654000,189,8470000,Washington County,Washington County-Contra Costa County-CA
1371,Washington County-Snohomish County-WA-1617,"Snohomish County, WA",1617,2016,2017,291,10674000,310,11019000,-19,-345000,Washington County,Washington County-Snohomish County-WA
1372,Washington County-Cook County-IL-1617,"Cook County, IL",1617,2016,2017,240,9757000,133,5992000,107,3765000,Washington County,Washington County-Cook County-IL
1373,Washington County-San Bernardino County-CA-1617,"San Bernardino County, CA",1617,2016,2017,262,7337000,93,2157000,169,5180000,Washington County,Washington County-San Bernardino County-CA
1374,Washington County-Linn County-OR-1617,"Linn County, OR",1617,2016,2017,201,5644000,257,8095000,-56,-2451000,Washington County,Washington County-Linn County-OR
1375,Washington County-Travis County-TX-1617,"Travis County, TX",1617,2016,2017,244,10265000,264,14241000,-20,-3976000,Washington County,Washington County-Travis County-TX
1376,Washington County-Clatsop County-OR-1617,"Clatsop County, OR",1617,2016,2017,192,4739000,303,11672000,-111,-6933000,Washington County,Washington County-Clatsop County-OR
1377,Washington County-San Mateo County-CA-1617,"San Mateo County, CA",1617,2016,2017,220,11037000,39,2378000,181,8659000,Washington County,Washington County-San Mateo County-CA
1378,Washington County-Ada County-ID-1617,"Ada County, ID",1617,2016,2017,221,7224000,457,16070000,-236,-8846000,Washington County,Washington County-Ada County-ID
1379,Washington County-Salt Lake County-UT-1617,"Salt Lake County, UT",1617,2016,2017,228,6531000,176,5697000,52,834000,Washington County,Washington County-Salt Lake County-UT
1380,Washington County-Thurston County-WA-1617,"Thurston County, WA",1617,2016,2017,217,10441000,170,5344000,47,5097000,Washington County,Washington County-Thurston County-WA
1381,Washington County-San Francisco County-CA-1617,"San Francisco County, CA",1617,2016,2017,159,11601000,62,4063000,97,7538000,Washington County,Washington County-San Francisco County-CA
1382,Washington County-Hennepin County-MN-1617,"Hennepin County, MN",1617,2016,2017,151,6649000,93,7000000,58,-351000,Washington County,Washington County-Hennepin County-MN
1383,Washington County-Harris County-TX-1617,"Harris County, TX",1617,2016,2017,157,8052000,162,4647000,-5,3405000,Washington County,Washington County-Harris County-TX
1384,Washington County-Bernalillo County-NM-1617,"Bernalillo County, NM",1617,2016,2017,171,7424000,59,2393000,112,5031000,Washington County,Washington County-Bernalillo County-NM
1385,Washington County-Dallas County-TX-1617,"Dallas County, TX",1617,2016,2017,153,5456000,129,5057000,24,399000,Washington County,Washington County-Dallas County-TX
1386,Washington County-Ventura County-CA-1617,"Ventura County, CA",1617,2016,2017,144,5383000,74,2676000,70,2707000,Washington County,Washington County-Ventura County-CA
1387,Washington County-Bexar County-TX-1617,"Bexar County, TX",1617,2016,2017,150,5142000,98,2714000,52,2428000,Washington County,Washington County-Bexar County-TX
1388,Washington County-Spokane County-WA-1617,"Spokane County, WA",1617,2016,2017,148,5581000,353,9890000,-205,-4309000,Washington County,Washington County-Spokane County-WA
1389,Washington County-Lincoln County-OR-1617,"Lincoln County, OR",1617,2016,2017,110,3095000,241,9971000,-131,-6876000,Washington County,Washington County-Lincoln County-OR
1390,Washington County-Pima County-AZ-1617,"Pima County, AZ",1617,2016,2017,112,3839000,146,5694000,-34,-1855000,Washington County,Washington County-Pima County-AZ
1391,Washington County-Tillamook County-OR-1617,"Tillamook County, OR",1617,2016,2017,107,3240000,246,8137000,-139,-4897000,Washington County,Washington County-Tillamook County-OR
1392,Washington County-Utah County-UT-1617,"Utah County, UT",1617,2016,2017,170,3691000,202,5237000,-32,-1546000,Washington County,Washington County-Utah County-UT
1393,Washington County-Cowlitz County-WA-1617,"Cowlitz County, WA",1617,2016,2017,131,2893000,268,6854000,-137,-3961000,Washington County,Washington County-Cowlitz County-WA
1394,Washington County-Douglas County-OR-1617,"Douglas County, OR",1617,2016,2017,111,2208000,155,5136000,-44,-2928000,Washington County,Washington County-Douglas County-OR
1395,Washington County-Kitsap County-WA-1617,"Kitsap County, WA",1617,2016,2017,136,3776000,91,3967000,45,-191000,Washington County,Washington County-Kitsap County-WA
1396,Washington County-Santa Barbara County-CA-1617,"Santa Barbara County, CA",1617,2016,2017,102,3868000,32,952000,70,2916000,Washington County,Washington County-Santa Barbara County-CA
1397,Washington County-Klamath County-OR-1617,"Klamath County, OR",1617,2016,2017,109,2523000,82,2227000,27,296000,Washington County,Washington County-Klamath County-OR
1398,Washington County-Anchorage Municipality-AK-1617,"Anchorage Municipality, AK",1617,2016,2017,113,3236000,37,869000,76,2367000,Washington County,Washington County-Anchorage Municipality-AK
1399,Washington County-Wake County-NC-1617,"Wake County, NC",1617,2016,2017,90,3866000,132,6080000,-42,-2214000,Washington County,Washington County-Wake County-NC
1400,Washington County-Denver County-CO-1617,"Denver County, CO",1617,2016,2017,99,7402000,84,4025000,15,3377000,Washington County,Washington County-Denver County-CO
1401,Washington County-Sonoma County-CA-1617,"Sonoma County, CA",1617,2016,2017,95,3235000,33,1223000,62,2012000,Washington County,Washington County-Sonoma County-CA
1402,Washington County-Middlesex County-MA-1617,"Middlesex County, MA",1617,2016,2017,97,5128000,113,7703000,-16,-2575000,Washington County,Washington County-Middlesex County-MA
1403,Washington County-Yakima County-WA-1617,"Yakima County, WA",1617,2016,2017,88,2656000,77,1713000,11,943000,Washington County,Washington County-Yakima County-WA
1404,Washington County-Collin County-TX-1617,"Collin County, TX",1617,2016,2017,110,6445000,181,6958000,-71,-513000,Washington County,Washington County-Collin County-TX
1405,Washington County-Franklin County-OH-1617,"Franklin County, OH",1617,2016,2017,80,2514000,63,1883000,17,631000,Washington County,Washington County-Franklin County-OH
1406,Washington County-Fairfax County-VA-1617,"Fairfax County, VA",1617,2016,2017,95,4709000,55,2037000,40,2672000,Washington County,Washington County-Fairfax County-VA
1407,Washington County-El Paso County-CO-1617,"El Paso County, CO",1617,2016,2017,82,2201000,92,2665000,-10,-464000,Washington County,Washington County-El Paso County-CO
1408,Washington County-Umatilla County-OR-1617,"Umatilla County, OR",1617,2016,2017,73,2325000,105,2799000,-32,-474000,Washington County,Washington County-Umatilla County-OR
1409,Washington County-Washoe County-NV-1617,"Washoe County, NV",1617,2016,2017,75,2937000,96,3575000,-21,-638000,Washington County,Washington County-Washoe County-NV
1410,Washington County-Josephine County-OR-1617,"Josephine County, OR",1617,2016,2017,72,1714000,90,2647000,-18,-933000,Washington County,Washington County-Josephine County-OR
1411,Washington County-Fulton County-GA-1617,"Fulton County, GA",1617,2016,2017,61,3170000,54,2109000,7,1061000,Washington County,Washington County-Fulton County-GA
1412,Washington County-Orange County-FL-1617,"Orange County, FL",1617,2016,2017,73,2887000,79,4018000,-6,-1131000,Washington County,Washington County-Orange County-FL
1413,Washington County-Fresno County-CA-1617,"Fresno County, CA",1617,2016,2017,101,2466000,56,1975000,45,491000,Washington County,Washington County-Fresno County-CA
1414,Washington County-Tarrant County-TX-1617,"Tarrant County, TX",1617,2016,2017,84,2480000,98,3498000,-14,-1018000,Washington County,Washington County-Tarrant County-TX
1415,Washington County-Kings County-NY-1617,"Kings County, NY",1617,2016,2017,71,4140000,40,1695000,31,2445000,Washington County,Washington County-Kings County-NY
1416,Washington County-Coos County-OR-1617,"Coos County, OR",1617,2016,2017,61,2219000,75,3142000,-14,-923000,Washington County,Washington County-Coos County-OR
1417,Washington County-Placer County-CA-1617,"Placer County, CA",1617,2016,2017,77,2656000,72,3575000,5,-919000,Washington County,Washington County-Placer County-CA
1418,Washington County-Arapahoe County-CO-1617,"Arapahoe County, CO",1617,2016,2017,59,2361000,82,2976000,-23,-615000,Washington County,Washington County-Arapahoe County-CO
1419,Washington County-Benton County-WA-1617,"Benton County, WA",1617,2016,2017,84,3001000,81,2611000,3,390000,Washington County,Washington County-Benton County-WA
1420,Washington County-Jefferson County-CO-1617,"Jefferson County, CO",1617,2016,2017,60,2808000,76,2775000,-16,33000,Washington County,Washington County-Jefferson County-CO
1421,Washington County-Larimer County-CO-1617,"Larimer County, CO",1617,2016,2017,63,2451000,57,1574000,6,877000,Washington County,Washington County-Larimer County-CO
1422,Washington County-Hawaii County-HI-1617,"Hawaii County, HI",1617,2016,2017,77,2763000,63,2749000,14,14000,Washington County,Washington County-Hawaii County-HI
1423,Washington County-Hood River County-OR-1617,"Hood River County, OR",1617,2016,2017,83,2143000,71,3739000,12,-1596000,Washington County,Washington County-Hood River County-OR
1424,Washington County-Allegheny County-PA-1617,"Allegheny County, PA",1617,2016,2017,56,2270000,43,1932000,13,338000,Washington County,Washington County-Allegheny County-PA
1425,Washington County-Monterey County-CA-1617,"Monterey County, CA",1617,2016,2017,70,1801000,46,1125000,24,676000,Washington County,Washington County-Monterey County-CA
1426,Washington County-New York County-NY-1617,"New York County, NY",1617,2016,2017,50,3864000,38,2355000,12,1509000,Washington County,Washington County-New York County-NY
1427,Washington County-Sandoval County-NM-1617,"Sandoval County, NM",1617,2016,2017,77,3649000,45,2312000,32,1337000,Washington County,Washington County-Sandoval County-NM
1428,Washington County-Davidson County-TN-1617,"Davidson County, TN",1617,2016,2017,43,1908000,39,1737000,4,171000,Washington County,Washington County-Davidson County-TN
1429,Washington County-DuPage County-IL-1617,"DuPage County, IL",1617,2016,2017,68,2498000,58,2640000,10,-142000,Washington County,Washington County-DuPage County-IL
1430,Washington County-Kern County-CA-1617,"Kern County, CA",1617,2016,2017,78,2219000,54,657000,24,1562000,Washington County,Washington County-Kern County-CA
1431,Washington County-Adams County-CO-1617,"Adams County, CO",1617,2016,2017,51,2858000,33,1470000,18,1388000,Washington County,Washington County-Adams County-CO
1432,Washington County-Wasco County-OR-1617,"Wasco County, OR",1617,2016,2017,59,1865000,77,2863000,-18,-998000,Washington County,Washington County-Wasco County-OR
1433,Washington County-Solano County-CA-1617,"Solano County, CA",1617,2016,2017,59,1752000,35,1437000,24,315000,Washington County,Washington County-Solano County-CA
1434,Washington County-District of Columbia-DC-1617,"District of Columbia, DC",1617,2016,2017,43,2430000,24,1386000,19,1044000,Washington County,Washington County-District of Columbia-DC
1435,Washington County-Canyon County-ID-1617,"Canyon County, ID",1617,2016,2017,59,973000,101,2117000,-42,-1144000,Washington County,Washington County-Canyon County-ID
1436,Washington County-Miami-Dade County-FL-1617,"Miami-Dade County, FL",1617,2016,2017,56,2012000,48,1620000,8,392000,Washington County,Washington County-Miami-Dade County-FL
1437,Washington County-Jackson County-MO-1617,"Jackson County, MO",1617,2016,2017,45,1916000,31,1023000,14,893000,Washington County,Washington County-Jackson County-MO
1438,Washington County-Mecklenburg County-NC-1617,"Mecklenburg County, NC",1617,2016,2017,46,2586000,64,2870000,-18,-284000,Washington County,Washington County-Mecklenburg County-NC
1439,Washington County-Williamson County-TX-1617,"Williamson County, TX",1617,2016,2017,73,2912000,138,7084000,-65,-4172000,Washington County,Washington County-Williamson County-TX
1440,Washington County-Whatcom County-WA-1617,"Whatcom County, WA",1617,2016,2017,42,1432000,59,2891000,-17,-1459000,Washington County,Washington County-Whatcom County-WA
1441,Washington County-Pinal County-AZ-1617,"Pinal County, AZ",1617,2016,2017,62,1552000,101,4572000,-39,-3020000,Washington County,Washington County-Pinal County-AZ
1442,Washington County-Oakland County-MI-1617,"Oakland County, MI",1617,2016,2017,59,2347000,50,1659000,9,688000,Washington County,Washington County-Oakland County-MI
1443,Washington County-Denton County-TX-1617,"Denton County, TX",1617,2016,2017,69,3001000,76,3221000,-7,-220000,Washington County,Washington County-Denton County-TX
1444,Washington County-Hillsborough County-FL-1617,"Hillsborough County, FL",1617,2016,2017,51,1704000,58,1599000,-7,105000,Washington County,Washington County-Hillsborough County-FL
1445,Washington County-Douglas County-CO-1617,"Douglas County, CO",1617,2016,2017,59,2639000,57,2004000,2,635000,Washington County,Washington County-Douglas County-CO
1446,Washington County-St. Louis County-MO-1617,"St. Louis County, MO",1617,2016,2017,55,2242000,63,2126000,-8,116000,Washington County,Washington County-St. Louis County-MO
1447,Washington County-Cuyahoga County-OH-1617,"Cuyahoga County, OH",1617,2016,2017,50,2217000,41,1746000,9,471000,Washington County,Washington County-Cuyahoga County-OH
1448,Washington County-Yavapai County-AZ-1617,"Yavapai County, AZ",1617,2016,2017,43,1087000,42,1390000,1,-303000,Washington County,Washington County-Yavapai County-AZ
1449,Washington County-Duval County-FL-1617,"Duval County, FL",1617,2016,2017,51,1586000,30,2088000,21,-502000,Washington County,Washington County-Duval County-FL
1450,Washington County-Shasta County-CA-1617,"Shasta County, CA",1617,2016,2017,50,1781000,30,714000,20,1067000,Washington County,Washington County-Shasta County-CA
1451,Washington County-Boulder County-CO-1617,"Boulder County, CO",1617,2016,2017,34,2004000,54,1707000,-20,297000,Washington County,Washington County-Boulder County-CO
1452,Washington County-Yellowstone County-MT-1617,"Yellowstone County, MT",1617,2016,2017,45,1670000,49,1194000,-4,476000,Washington County,Washington County-Yellowstone County-MT
1453,Washington County-Saratoga County-NY-1617,"Saratoga County, NY",1617,2016,2017,56,2968000,66,3938000,-10,-970000,Washington County,Washington County-Saratoga County-NY
1454,Washington County-Walla Walla County-WA-1617,"Walla Walla County, WA",1617,2016,2017,34,1389000,49,1777000,-15,-388000,Washington County,Washington County-Walla Walla County-WA
1455,Washington County-Pacific County-WA-1617,"Pacific County, WA",1617,2016,2017,36,830000,43,1908000,-7,-1078000,Washington County,Washington County-Pacific County-WA
1456,Washington County-Missoula County-MT-1617,"Missoula County, MT",1617,2016,2017,29,529000,55,1368000,-26,-839000,Washington County,Washington County-Missoula County-MT
1459,Yamhill County-Washington County-OR-1617,"Washington County, OR",1617,2016,2017,2719,90171000,1096,31828000,1623,58343000,Yamhill County,Yamhill County-Washington County-OR
1460,Yamhill County-Multnomah County-OR-1617,"Multnomah County, OR",1617,2016,2017,572,21041000,359,10692000,213,10349000,Yamhill County,Yamhill County-Multnomah County-OR
1461,Yamhill County-Clackamas County-OR-1617,"Clackamas County, OR",1617,2016,2017,599,20064000,427,18545000,172,1519000,Yamhill County,Yamhill County-Clackamas County-OR
1462,Yamhill County-Marion County-OR-1617,"Marion County, OR",1617,2016,2017,500,10042000,695,19765000,-195,-9723000,Yamhill County,Yamhill County-Marion County-OR
1463,Yamhill County-Polk County-OR-1617,"Polk County, OR",1617,2016,2017,409,8501000,679,15604000,-270,-7103000,Yamhill County,Yamhill County-Polk County-OR
1464,Yamhill County-Lane County-OR-1617,"Lane County, OR",1617,2016,2017,93,2479000,121,2596000,-28,-117000,Yamhill County,Yamhill County-Lane County-OR
1465,Yamhill County-Clark County-WA-1617,"Clark County, WA",1617,2016,2017,105,3756000,161,4153000,-56,-397000,Yamhill County,Yamhill County-Clark County-WA
1466,Yamhill County-King County-WA-1617,"King County, WA",1617,2016,2017,105,4688000,58,1518000,47,3170000,Yamhill County,Yamhill County-King County-WA
1467,Yamhill County-Deschutes County-OR-1617,"Deschutes County, OR",1617,2016,2017,92,2515000,228,5881000,-136,-3366000,Yamhill County,Yamhill County-Deschutes County-OR
1468,Yamhill County-Benton County-OR-1617,"Benton County, OR",1617,2016,2017,62,1629000,58,1873000,4,-244000,Yamhill County,Yamhill County-Benton County-OR
1469,Yamhill County-Lincoln County-OR-1617,"Lincoln County, OR",1617,2016,2017,80,1349000,122,3091000,-42,-1742000,Yamhill County,Yamhill County-Lincoln County-OR
1470,Yamhill County-Linn County-OR-1617,"Linn County, OR",1617,2016,2017,66,1725000,91,1961000,-25,-236000,Yamhill County,Yamhill County-Linn County-OR
1471,Yamhill County-Maricopa County-AZ-1617,"Maricopa County, AZ",1617,2016,2017,64,2029000,105,3035000,-41,-1006000,Yamhill County,Yamhill County-Maricopa County-AZ
1472,Yamhill County-Columbia County-OR-1617,"Columbia County, OR",1617,2016,2017,68,1921000,53,1378000,15,543000,Yamhill County,Yamhill County-Columbia County-OR
1473,Yamhill County-Jackson County-OR-1617,"Jackson County, OR",1617,2016,2017,41,1037000,48,1051000,-7,-14000,Yamhill County,Yamhill County-Jackson County-OR
1474,Yamhill County-San Diego County-CA-1617,"San Diego County, CA",1617,2016,2017,66,2028000,50,718000,16,1310000,Yamhill County,Yamhill County-San Diego County-CA
1475,Yamhill County-Tillamook County-OR-1617,"Tillamook County, OR",1617,2016,2017,47,1276000,77,1487000,-30,-211000,Yamhill County,Yamhill County-Tillamook County-OR
1476,Yamhill County-Spokane County-WA-1617,"Spokane County, WA",1617,2016,2017,35,837000,45,1282000,-10,-445000,Yamhill County,Yamhill County-Spokane County-WA
1477,Yamhill County-Clark County-NV-1617,"Clark County, NV",1617,2016,2017,34,1268000,52,1157000,-18,111000,Yamhill County,Yamhill County-Clark County-NV
1479,Baker County-Union County-OR-1819,"Union County, OR",1819,2018,2019,97,2149000,71,1476000,26,673000,Baker County,Baker County-Union County-OR
1481,Benton County-Linn County-OR-1819,"Linn County, OR",1819,2018,2019,1047,29731000,1220,37122000,-173,-7391000,Benton County,Benton County-Linn County-OR
1482,Benton County-Lane County-OR-1819,"Lane County, OR",1819,2018,2019,349,9395000,356,9651000,-7,-256000,Benton County,Benton County-Lane County-OR
1483,Benton County-Multnomah County-OR-1819,"Multnomah County, OR",1819,2018,2019,224,10017000,371,11908000,-147,-1891000,Benton County,Benton County-Multnomah County-OR
1484,Benton County-Marion County-OR-1819,"Marion County, OR",1819,2018,2019,252,7230000,245,8643000,7,-1413000,Benton County,Benton County-Marion County-OR
1485,Benton County-Washington County-OR-1819,"Washington County, OR",1819,2018,2019,171,5068000,314,9747000,-143,-4679000,Benton County,Benton County-Washington County-OR
1486,Benton County-Polk County-OR-1819,"Polk County, OR",1819,2018,2019,188,4311000,188,4888000,0,-577000,Benton County,Benton County-Polk County-OR
1487,Benton County-Clackamas County-OR-1819,"Clackamas County, OR",1819,2018,2019,114,4272000,139,4570000,-25,-298000,Benton County,Benton County-Clackamas County-OR
1488,Benton County-Lincoln County-OR-1819,"Lincoln County, OR",1819,2018,2019,120,4022000,79,3683000,41,339000,Benton County,Benton County-Lincoln County-OR
1489,Benton County-Deschutes County-OR-1819,"Deschutes County, OR",1819,2018,2019,80,2892000,135,5556000,-55,-2664000,Benton County,Benton County-Deschutes County-OR
1490,Benton County-Jackson County-OR-1819,"Jackson County, OR",1819,2018,2019,78,2188000,57,1433000,21,755000,Benton County,Benton County-Jackson County-OR
1491,Benton County-King County-WA-1819,"King County, WA",1819,2018,2019,77,6756000,100,3635000,-23,3121000,Benton County,Benton County-King County-WA
1492,Benton County-Los Angeles County-CA-1819,"Los Angeles County, CA",1819,2018,2019,66,3305000,55,1035000,11,2270000,Benton County,Benton County-Los Angeles County-CA
1493,Benton County-Douglas County-OR-1819,"Douglas County, OR",1819,2018,2019,58,1570000,42,784000,16,786000,Benton County,Benton County-Douglas County-OR
1494,Benton County-Maricopa County-AZ-1819,"Maricopa County, AZ",1819,2018,2019,53,1624000,83,3264000,-30,-1640000,Benton County,Benton County-Maricopa County-AZ
1495,Benton County-San Diego County-CA-1819,"San Diego County, CA",1819,2018,2019,48,1739000,48,1854000,0,-115000,Benton County,Benton County-San Diego County-CA
1496,Benton County-Yamhill County-OR-1819,"Yamhill County, OR",1819,2018,2019,42,1014000,44,1815000,-2,-801000,Benton County,Benton County-Yamhill County-OR
1497,Benton County-Santa Clara County-CA-1819,"Santa Clara County, CA",1819,2018,2019,46,2656000,54,2857000,-8,-201000,Benton County,Benton County-Santa Clara County-CA
1499,Clackamas County-Multnomah County-OR-1819,"Multnomah County, OR",1819,2018,2019,8956,375923000,6267,230740000,2689,145183000,Clackamas County,Clackamas County-Multnomah County-OR
1500,Clackamas County-Washington County-OR-1819,"Washington County, OR",1819,2018,2019,3797,168063000,3205,161719000,592,6344000,Clackamas County,Clackamas County-Washington County-OR
1501,Clackamas County-Marion County-OR-1819,"Marion County, OR",1819,2018,2019,1252,38978000,1709,49746000,-457,-10768000,Clackamas County,Clackamas County-Marion County-OR
1502,Clackamas County-Clark County-WA-1819,"Clark County, WA",1819,2018,2019,1046,39942000,1486,72858000,-440,-32916000,Clackamas County,Clackamas County-Clark County-WA
1503,Clackamas County-Lane County-OR-1819,"Lane County, OR",1819,2018,2019,365,13604000,283,8892000,82,4712000,Clackamas County,Clackamas County-Lane County-OR
1504,Clackamas County-Los Angeles County-CA-1819,"Los Angeles County, CA",1819,2018,2019,412,19258000,207,8968000,205,10290000,Clackamas County,Clackamas County-Los Angeles County-CA
1505,Clackamas County-Yamhill County-OR-1819,"Yamhill County, OR",1819,2018,2019,340,11186000,395,15122000,-55,-3936000,Clackamas County,Clackamas County-Yamhill County-OR
1506,Clackamas County-King County-WA-1819,"King County, WA",1819,2018,2019,292,17076000,266,14342000,26,2734000,Clackamas County,Clackamas County-King County-WA
1507,Clackamas County-Deschutes County-OR-1819,"Deschutes County, OR",1819,2018,2019,270,10923000,529,40583000,-259,-29660000,Clackamas County,Clackamas County-Deschutes County-OR
1508,Clackamas County-Maricopa County-AZ-1819,"Maricopa County, AZ",1819,2018,2019,235,8546000,443,23857000,-208,-15311000,Clackamas County,Clackamas County-Maricopa County-AZ
1509,Clackamas County-San Diego County-CA-1819,"San Diego County, CA",1819,2018,2019,194,8170000,134,8216000,60,-46000,Clackamas County,Clackamas County-San Diego County-CA
1510,Clackamas County-Benton County-OR-1819,"Benton County, OR",1819,2018,2019,139,4570000,114,4272000,25,298000,Clackamas County,Clackamas County-Benton County-OR
1511,Clackamas County-Santa Clara County-CA-1819,"Santa Clara County, CA",1819,2018,2019,216,17721000,58,2974000,158,14747000,Clackamas County,Clackamas County-Santa Clara County-CA
1512,Clackamas County-Polk County-OR-1819,"Polk County, OR",1819,2018,2019,140,4179000,144,4167000,-4,12000,Clackamas County,Clackamas County-Polk County-OR
1513,Clackamas County-Orange County-CA-1819,"Orange County, CA",1819,2018,2019,161,10682000,96,6118000,65,4564000,Clackamas County,Clackamas County-Orange County-CA
1514,Clackamas County-Linn County-OR-1819,"Linn County, OR",1819,2018,2019,127,4055000,154,4172000,-27,-117000,Clackamas County,Clackamas County-Linn County-OR
1515,Clackamas County-Alameda County-CA-1819,"Alameda County, CA",1819,2018,2019,126,12318000,47,2942000,79,9376000,Clackamas County,Clackamas County-Alameda County-CA
1516,Clackamas County-Jackson County-OR-1819,"Jackson County, OR",1819,2018,2019,114,3861000,113,4840000,1,-979000,Clackamas County,Clackamas County-Jackson County-OR
1517,Clackamas County-Columbia County-OR-1819,"Columbia County, OR",1819,2018,2019,117,4030000,172,5230000,-55,-1200000,Clackamas County,Clackamas County-Columbia County-OR
1518,Clackamas County-Pierce County-WA-1819,"Pierce County, WA",1819,2018,2019,170,5519000,126,6069000,44,-550000,Clackamas County,Clackamas County-Pierce County-WA
1519,Clackamas County-Honolulu County-HI-1819,"Honolulu County, HI",1819,2018,2019,122,4447000,58,1725000,64,2722000,Clackamas County,Clackamas County-Honolulu County-HI
1520,Clackamas County-Riverside County-CA-1819,"Riverside County, CA",1819,2018,2019,105,3973000,98,7271000,7,-3298000,Clackamas County,Clackamas County-Riverside County-CA
1521,Clackamas County-Clark County-NV-1819,"Clark County, NV",1819,2018,2019,117,3110000,126,18016000,-9,-14906000,Clackamas County,Clackamas County-Clark County-NV
1522,Clackamas County-Spokane County-WA-1819,"Spokane County, WA",1819,2018,2019,75,3196000,101,2684000,-26,512000,Clackamas County,Clackamas County-Spokane County-WA
1523,Clackamas County-Clatsop County-OR-1819,"Clatsop County, OR",1819,2018,2019,79,2049000,94,5573000,-15,-3524000,Clackamas County,Clackamas County-Clatsop County-OR
1524,Clackamas County-Pima County-AZ-1819,"Pima County, AZ",1819,2018,2019,86,4382000,57,2981000,29,1401000,Clackamas County,Clackamas County-Pima County-AZ
1525,Clackamas County-San Bernardino County-CA-1819,"San Bernardino County, CA",1819,2018,2019,80,3432000,36,1058000,44,2374000,Clackamas County,Clackamas County-San Bernardino County-CA
1526,Clackamas County-Lincoln County-OR-1819,"Lincoln County, OR",1819,2018,2019,85,3305000,129,4545000,-44,-1240000,Clackamas County,Clackamas County-Lincoln County-OR
1527,Clackamas County-Snohomish County-WA-1819,"Snohomish County, WA",1819,2018,2019,114,3793000,117,4607000,-3,-814000,Clackamas County,Clackamas County-Snohomish County-WA
1528,Clackamas County-Sacramento County-CA-1819,"Sacramento County, CA",1819,2018,2019,72,2987000,50,2056000,22,931000,Clackamas County,Clackamas County-Sacramento County-CA
1529,Clackamas County-Salt Lake County-UT-1819,"Salt Lake County, UT",1819,2018,2019,90,2764000,89,2406000,1,358000,Clackamas County,Clackamas County-Salt Lake County-UT
1530,Clackamas County-Ada County-ID-1819,"Ada County, ID",1819,2018,2019,59,2345000,105,4999000,-46,-2654000,Clackamas County,Clackamas County-Ada County-ID
1531,Clackamas County-Cowlitz County-WA-1819,"Cowlitz County, WA",1819,2018,2019,57,1521000,123,3237000,-66,-1716000,Clackamas County,Clackamas County-Cowlitz County-WA
1532,Clackamas County-San Francisco County-CA-1819,"San Francisco County, CA",1819,2018,2019,63,5638000,37,1994000,26,3644000,Clackamas County,Clackamas County-San Francisco County-CA
1533,Clackamas County-Ventura County-CA-1819,"Ventura County, CA",1819,2018,2019,59,1965000,34,1705000,25,260000,Clackamas County,Clackamas County-Ventura County-CA
1534,Clackamas County-Douglas County-OR-1819,"Douglas County, OR",1819,2018,2019,51,1723000,64,2434000,-13,-711000,Clackamas County,Clackamas County-Douglas County-OR
1535,Clackamas County-Thurston County-WA-1819,"Thurston County, WA",1819,2018,2019,59,2070000,61,2164000,-2,-94000,Clackamas County,Clackamas County-Thurston County-WA
1536,Clackamas County-Cook County-IL-1819,"Cook County, IL",1819,2018,2019,57,3819000,35,1793000,22,2026000,Clackamas County,Clackamas County-Cook County-IL
1537,Clackamas County-Wasco County-OR-1819,"Wasco County, OR",1819,2018,2019,48,1918000,82,2514000,-34,-596000,Clackamas County,Clackamas County-Wasco County-OR
1538,Clackamas County-Tillamook County-OR-1819,"Tillamook County, OR",1819,2018,2019,49,1344000,96,3558000,-47,-2214000,Clackamas County,Clackamas County-Tillamook County-OR
1539,Clackamas County-Jefferson County-OR-1819,"Jefferson County, OR",1819,2018,2019,47,1059000,72,2776000,-25,-1717000,Clackamas County,Clackamas County-Jefferson County-OR
1540,Clackamas County-Klamath County-OR-1819,"Klamath County, OR",1819,2018,2019,32,824000,67,2716000,-35,-1892000,Clackamas County,Clackamas County-Klamath County-OR
1541,Clackamas County-Washoe County-NV-1819,"Washoe County, NV",1819,2018,2019,40,1584000,34,3233000,6,-1649000,Clackamas County,Clackamas County-Washoe County-NV
1542,Clackamas County-Umatilla County-OR-1819,"Umatilla County, OR",1819,2018,2019,45,1325000,46,1788000,-1,-463000,Clackamas County,Clackamas County-Umatilla County-OR
1543,Clackamas County-Denver County-CO-1819,"Denver County, CO",1819,2018,2019,36,3915000,37,1221000,-1,2694000,Clackamas County,Clackamas County-Denver County-CO
1544,Clackamas County-Coos County-OR-1819,"Coos County, OR",1819,2018,2019,37,1847000,47,1485000,-10,362000,Clackamas County,Clackamas County-Coos County-OR
1545,Clackamas County-Travis County-TX-1819,"Travis County, TX",1819,2018,2019,46,2541000,44,5198000,2,-2657000,Clackamas County,Clackamas County-Travis County-TX
1546,Clackamas County-Benton County-WA-1819,"Benton County, WA",1819,2018,2019,42,1276000,64,1654000,-22,-378000,Clackamas County,Clackamas County-Benton County-WA
1547,Clackamas County-Crook County-OR-1819,"Crook County, OR",1819,2018,2019,35,773000,112,5166000,-77,-4393000,Clackamas County,Clackamas County-Crook County-OR
1548,Clackamas County-Hood River County-OR-1819,"Hood River County, OR",1819,2018,2019,36,1306000,54,1492000,-18,-186000,Clackamas County,Clackamas County-Hood River County-OR
1549,Clackamas County-Hawaii County-HI-1819,"Hawaii County, HI",1819,2018,2019,32,859000,30,1402000,2,-543000,Clackamas County,Clackamas County-Hawaii County-HI
1551,Clatsop County-Multnomah County-OR-1819,"Multnomah County, OR",1819,2018,2019,239,21468000,154,5837000,85,15631000,Clatsop County,Clatsop County-Multnomah County-OR
1552,Clatsop County-Washington County-OR-1819,"Washington County, OR",1819,2018,2019,167,5727000,151,5331000,16,396000,Clatsop County,Clatsop County-Washington County-OR
1553,Clatsop County-Clackamas County-OR-1819,"Clackamas County, OR",1819,2018,2019,94,5573000,79,2049000,15,3524000,Clatsop County,Clatsop County-Clackamas County-OR
1554,Clatsop County-King County-WA-1819,"King County, WA",1819,2018,2019,71,3268000,43,1354000,28,1914000,Clatsop County,Clatsop County-King County-WA
1555,Clatsop County-Pacific County-WA-1819,"Pacific County, WA",1819,2018,2019,86,2562000,123,3552000,-37,-990000,Clatsop County,Clatsop County-Pacific County-WA
1556,Clatsop County-Columbia County-OR-1819,"Columbia County, OR",1819,2018,2019,79,1513000,48,1624000,31,-111000,Clatsop County,Clatsop County-Columbia County-OR
1557,Clatsop County-Tillamook County-OR-1819,"Tillamook County, OR",1819,2018,2019,50,1418000,55,1075000,-5,343000,Clatsop County,Clatsop County-Tillamook County-OR
1558,Clatsop County-Clark County-WA-1819,"Clark County, WA",1819,2018,2019,66,1525000,79,2761000,-13,-1236000,Clatsop County,Clatsop County-Clark County-WA
1559,Clatsop County-Marion County-OR-1819,"Marion County, OR",1819,2018,2019,50,1140000,44,966000,6,174000,Clatsop County,Clatsop County-Marion County-OR
1560,Clatsop County-Cowlitz County-WA-1819,"Cowlitz County, WA",1819,2018,2019,46,883000,64,1138000,-18,-255000,Clatsop County,Clatsop County-Cowlitz County-WA
1561,Clatsop County-Lane County-OR-1819,"Lane County, OR",1819,2018,2019,35,715000,47,1228000,-12,-513000,Clatsop County,Clatsop County-Lane County-OR
1563,Columbia County-Washington County-OR-1819,"Washington County, OR",1819,2018,2019,639,22470000,415,11246000,224,11224000,Columbia County,Columbia County-Washington County-OR
1564,Columbia County-Multnomah County-OR-1819,"Multnomah County, OR",1819,2018,2019,550,20298000,268,9116000,282,11182000,Columbia County,Columbia County-Multnomah County-OR
1565,Columbia County-Cowlitz County-WA-1819,"Cowlitz County, WA",1819,2018,2019,195,4069000,278,7215000,-83,-3146000,Columbia County,Columbia County-Cowlitz County-WA
1566,Columbia County-Clackamas County-OR-1819,"Clackamas County, OR",1819,2018,2019,172,5230000,117,4030000,55,1200000,Columbia County,Columbia County-Clackamas County-OR
1567,Columbia County-Clark County-WA-1819,"Clark County, WA",1819,2018,2019,139,3510000,135,4515000,4,-1005000,Columbia County,Columbia County-Clark County-WA
1568,Columbia County-Clatsop County-OR-1819,"Clatsop County, OR",1819,2018,2019,48,1624000,79,1513000,-31,111000,Columbia County,Columbia County-Clatsop County-OR
1569,Columbia County-Yamhill County-OR-1819,"Yamhill County, OR",1819,2018,2019,43,1120000,52,1879000,-9,-759000,Columbia County,Columbia County-Yamhill County-OR
1571,Coos County-Lane County-OR-1819,"Lane County, OR",1819,2018,2019,228,5150000,256,6848000,-28,-1698000,Coos County,Coos County-Lane County-OR
1572,Coos County-Douglas County-OR-1819,"Douglas County, OR",1819,2018,2019,174,3597000,159,4194000,15,-597000,Coos County,Coos County-Douglas County-OR
1573,Coos County-Jackson County-OR-1819,"Jackson County, OR",1819,2018,2019,111,2161000,84,2238000,27,-77000,Coos County,Coos County-Jackson County-OR
1574,Coos County-Multnomah County-OR-1819,"Multnomah County, OR",1819,2018,2019,74,2160000,93,2765000,-19,-605000,Coos County,Coos County-Multnomah County-OR
1575,Coos County-Curry County-OR-1819,"Curry County, OR",1819,2018,2019,85,2201000,89,2975000,-4,-774000,Coos County,Coos County-Curry County-OR
1576,Coos County-Josephine County-OR-1819,"Josephine County, OR",1819,2018,2019,68,1779000,58,1470000,10,309000,Coos County,Coos County-Josephine County-OR
1577,Coos County-Marion County-OR-1819,"Marion County, OR",1819,2018,2019,57,1428000,68,1836000,-11,-408000,Coos County,Coos County-Marion County-OR
1578,Coos County-Clackamas County-OR-1819,"Clackamas County, OR",1819,2018,2019,47,1485000,37,1847000,10,-362000,Coos County,Coos County-Clackamas County-OR
1579,Coos County-Maricopa County-AZ-1819,"Maricopa County, AZ",1819,2018,2019,49,1033000,41,1601000,8,-568000,Coos County,Coos County-Maricopa County-AZ
1580,Coos County-Linn County-OR-1819,"Linn County, OR",1819,2018,2019,47,793000,40,759000,7,34000,Coos County,Coos County-Linn County-OR
1581,Coos County-Washington County-OR-1819,"Washington County, OR",1819,2018,2019,45,1272000,41,1376000,4,-104000,Coos County,Coos County-Washington County-OR
1582,Coos County-Deschutes County-OR-1819,"Deschutes County, OR",1819,2018,2019,36,1008000,67,1613000,-31,-605000,Coos County,Coos County-Deschutes County-OR
1584,Crook County-Deschutes County-OR-1819,"Deschutes County, OR",1819,2018,2019,637,18420000,440,11961000,197,6459000,Crook County,Crook County-Deschutes County-OR
1585,Crook County-Clackamas County-OR-1819,"Clackamas County, OR",1819,2018,2019,112,5166000,35,773000,77,4393000,Crook County,Crook County-Clackamas County-OR
1586,Crook County-Jefferson County-OR-1819,"Jefferson County, OR",1819,2018,2019,69,1344000,112,1854000,-43,-510000,Crook County,Crook County-Jefferson County-OR
1588,Curry County-Jackson County-OR-1819,"Jackson County, OR",1819,2018,2019,88,2536000,107,2956000,-19,-420000,Curry County,Curry County-Jackson County-OR
1589,Curry County-Coos County-OR-1819,"Coos County, OR",1819,2018,2019,89,2975000,85,2201000,4,774000,Curry County,Curry County-Coos County-OR
1590,Curry County-Del Norte County-CA-1819,"Del Norte County, CA",1819,2018,2019,74,1844000,56,1726000,18,118000,Curry County,Curry County-Del Norte County-CA
1591,Curry County-Josephine County-OR-1819,"Josephine County, OR",1819,2018,2019,46,1057000,44,1754000,2,-697000,Curry County,Curry County-Josephine County-OR
1593,Deschutes County-Multnomah County-OR-1819,"Multnomah County, OR",1819,2018,2019,738,53218000,387,18930000,351,34288000,Deschutes County,Deschutes County-Multnomah County-OR
1594,Deschutes County-Washington County-OR-1819,"Washington County, OR",1819,2018,2019,565,30209000,260,12011000,305,18198000,Deschutes County,Deschutes County-Washington County-OR
1595,Deschutes County-Lane County-OR-1819,"Lane County, OR",1819,2018,2019,497,17680000,359,9074000,138,8606000,Deschutes County,Deschutes County-Lane County-OR
1596,Deschutes County-Clackamas County-OR-1819,"Clackamas County, OR",1819,2018,2019,529,40583000,270,10923000,259,29660000,Deschutes County,Deschutes County-Clackamas County-OR
1597,Deschutes County-Crook County-OR-1819,"Crook County, OR",1819,2018,2019,440,11961000,637,18420000,-197,-6459000,Deschutes County,Deschutes County-Crook County-OR
1598,Deschutes County-King County-WA-1819,"King County, WA",1819,2018,2019,349,26969000,172,12464000,177,14505000,Deschutes County,Deschutes County-King County-WA
1599,Deschutes County-Los Angeles County-CA-1819,"Los Angeles County, CA",1819,2018,2019,343,28222000,87,4264000,256,23958000,Deschutes County,Deschutes County-Los Angeles County-CA
1600,Deschutes County-Marion County-OR-1819,"Marion County, OR",1819,2018,2019,339,18724000,226,5276000,113,13448000,Deschutes County,Deschutes County-Marion County-OR
1601,Deschutes County-Jefferson County-OR-1819,"Jefferson County, OR",1819,2018,2019,341,7497000,586,14367000,-245,-6870000,Deschutes County,Deschutes County-Jefferson County-OR
1602,Deschutes County-San Diego County-CA-1819,"San Diego County, CA",1819,2018,2019,297,17591000,100,6633000,197,10958000,Deschutes County,Deschutes County-San Diego County-CA
1603,Deschutes County-Jackson County-OR-1819,"Jackson County, OR",1819,2018,2019,225,15278000,139,5469000,86,9809000,Deschutes County,Deschutes County-Jackson County-OR
1604,Deschutes County-Orange County-CA-1819,"Orange County, CA",1819,2018,2019,242,15887000,49,2603000,193,13284000,Deschutes County,Deschutes County-Orange County-CA
1605,Deschutes County-Maricopa County-AZ-1819,"Maricopa County, AZ",1819,2018,2019,184,8334000,244,10601000,-60,-2267000,Deschutes County,Deschutes County-Maricopa County-AZ
1606,Deschutes County-Clark County-WA-1819,"Clark County, WA",1819,2018,2019,196,9183000,126,5928000,70,3255000,Deschutes County,Deschutes County-Clark County-WA
1607,Deschutes County-Klamath County-OR-1819,"Klamath County, OR",1819,2018,2019,174,4222000,192,4150000,-18,72000,Deschutes County,Deschutes County-Klamath County-OR
1608,Deschutes County-Benton County-OR-1819,"Benton County, OR",1819,2018,2019,135,5556000,80,2892000,55,2664000,Deschutes County,Deschutes County-Benton County-OR
1609,Deschutes County-Santa Clara County-CA-1819,"Santa Clara County, CA",1819,2018,2019,154,17281000,42,2921000,112,14360000,Deschutes County,Deschutes County-Santa Clara County-CA
1610,Deschutes County-Linn County-OR-1819,"Linn County, OR",1819,2018,2019,142,3689000,135,3548000,7,141000,Deschutes County,Deschutes County-Linn County-OR
1611,Deschutes County-Alameda County-CA-1819,"Alameda County, CA",1819,2018,2019,149,14517000,39,1573000,110,12944000,Deschutes County,Deschutes County-Alameda County-CA
1612,Deschutes County-Riverside County-CA-1819,"Riverside County, CA",1819,2018,2019,146,8542000,69,6570000,77,1972000,Deschutes County,Deschutes County-Riverside County-CA
1613,Deschutes County-Yamhill County-OR-1819,"Yamhill County, OR",1819,2018,2019,119,3235000,64,1823000,55,1412000,Deschutes County,Deschutes County-Yamhill County-OR
1614,Deschutes County-Douglas County-OR-1819,"Douglas County, OR",1819,2018,2019,97,4745000,82,2436000,15,2309000,Deschutes County,Deschutes County-Douglas County-OR
1615,Deschutes County-Pierce County-WA-1819,"Pierce County, WA",1819,2018,2019,102,5374000,53,1758000,49,3616000,Deschutes County,Deschutes County-Pierce County-WA
1616,Deschutes County-Polk County-OR-1819,"Polk County, OR",1819,2018,2019,94,2438000,70,2056000,24,382000,Deschutes County,Deschutes County-Polk County-OR
1617,Deschutes County-Lincoln County-OR-1819,"Lincoln County, OR",1819,2018,2019,97,2236000,68,1729000,29,507000,Deschutes County,Deschutes County-Lincoln County-OR
1618,Deschutes County-Ada County-ID-1819,"Ada County, ID",1819,2018,2019,88,3200000,142,5533000,-54,-2333000,Deschutes County,Deschutes County-Ada County-ID
1619,Deschutes County-Sacramento County-CA-1819,"Sacramento County, CA",1819,2018,2019,88,4061000,39,634000,49,3427000,Deschutes County,Deschutes County-Sacramento County-CA
1620,Deschutes County-Clark County-NV-1819,"Clark County, NV",1819,2018,2019,93,3136000,113,5069000,-20,-1933000,Deschutes County,Deschutes County-Clark County-NV
1621,Deschutes County-Washoe County-NV-1819,"Washoe County, NV",1819,2018,2019,65,3424000,50,2204000,15,1220000,Deschutes County,Deschutes County-Washoe County-NV
1622,Deschutes County-Coos County-OR-1819,"Coos County, OR",1819,2018,2019,67,1613000,36,1008000,31,605000,Deschutes County,Deschutes County-Coos County-OR
1623,Deschutes County-San Francisco County-CA-1819,"San Francisco County, CA",1819,2018,2019,50,6924000,25,1709000,25,5215000,Deschutes County,Deschutes County-San Francisco County-CA
1624,Deschutes County-Travis County-TX-1819,"Travis County, TX",1819,2018,2019,61,4431000,34,1575000,27,2856000,Deschutes County,Deschutes County-Travis County-TX
1625,Deschutes County-Spokane County-WA-1819,"Spokane County, WA",1819,2018,2019,56,2642000,65,2369000,-9,273000,Deschutes County,Deschutes County-Spokane County-WA
1626,Deschutes County-Salt Lake County-UT-1819,"Salt Lake County, UT",1819,2018,2019,63,3141000,31,878000,32,2263000,Deschutes County,Deschutes County-Salt Lake County-UT
1627,Deschutes County-Snohomish County-WA-1819,"Snohomish County, WA",1819,2018,2019,59,5721000,25,1132000,34,4589000,Deschutes County,Deschutes County-Snohomish County-WA
1628,Deschutes County-Pima County-AZ-1819,"Pima County, AZ",1819,2018,2019,45,1282000,94,5698000,-49,-4416000,Deschutes County,Deschutes County-Pima County-AZ
1629,Deschutes County-Denver County-CO-1819,"Denver County, CO",1819,2018,2019,39,2969000,29,1594000,10,1375000,Deschutes County,Deschutes County-Denver County-CO
1630,Deschutes County-Josephine County-OR-1819,"Josephine County, OR",1819,2018,2019,42,1283000,56,1711000,-14,-428000,Deschutes County,Deschutes County-Josephine County-OR
1631,Deschutes County-Umatilla County-OR-1819,"Umatilla County, OR",1819,2018,2019,41,1650000,38,992000,3,658000,Deschutes County,Deschutes County-Umatilla County-OR
1632,Deschutes County-Wasco County-OR-1819,"Wasco County, OR",1819,2018,2019,34,774000,43,1228000,-9,-454000,Deschutes County,Deschutes County-Wasco County-OR
1634,Douglas County-Lane County-OR-1819,"Lane County, OR",1819,2018,2019,503,9239000,452,8067000,51,1172000,Douglas County,Douglas County-Lane County-OR
1635,Douglas County-Coos County-OR-1819,"Coos County, OR",1819,2018,2019,159,4194000,174,3597000,-15,597000,Douglas County,Douglas County-Coos County-OR
1636,Douglas County-Jackson County-OR-1819,"Jackson County, OR",1819,2018,2019,157,3300000,149,3664000,8,-364000,Douglas County,Douglas County-Jackson County-OR
1637,Douglas County-Josephine County-OR-1819,"Josephine County, OR",1819,2018,2019,133,2514000,133,2926000,0,-412000,Douglas County,Douglas County-Josephine County-OR
1638,Douglas County-Washington County-OR-1819,"Washington County, OR",1819,2018,2019,129,3613000,86,2119000,43,1494000,Douglas County,Douglas County-Washington County-OR
1639,Douglas County-Multnomah County-OR-1819,"Multnomah County, OR",1819,2018,2019,80,2407000,71,1553000,9,854000,Douglas County,Douglas County-Multnomah County-OR
1640,Douglas County-Marion County-OR-1819,"Marion County, OR",1819,2018,2019,91,2338000,101,3104000,-10,-766000,Douglas County,Douglas County-Marion County-OR
1641,Douglas County-Deschutes County-OR-1819,"Deschutes County, OR",1819,2018,2019,82,2436000,97,4745000,-15,-2309000,Douglas County,Douglas County-Deschutes County-OR
1642,Douglas County-Clackamas County-OR-1819,"Clackamas County, OR",1819,2018,2019,64,2434000,51,1723000,13,711000,Douglas County,Douglas County-Clackamas County-OR
1643,Douglas County-San Diego County-CA-1819,"San Diego County, CA",1819,2018,2019,72,2150000,35,1290000,37,860000,Douglas County,Douglas County-San Diego County-CA
1644,Douglas County-Maricopa County-AZ-1819,"Maricopa County, AZ",1819,2018,2019,63,2914000,58,1663000,5,1251000,Douglas County,Douglas County-Maricopa County-AZ
1645,Douglas County-Klamath County-OR-1819,"Klamath County, OR",1819,2018,2019,58,1032000,45,1060000,13,-28000,Douglas County,Douglas County-Klamath County-OR
1646,Douglas County-Benton County-OR-1819,"Benton County, OR",1819,2018,2019,42,784000,58,1570000,-16,-786000,Douglas County,Douglas County-Benton County-OR
1647,Douglas County-Linn County-OR-1819,"Linn County, OR",1819,2018,2019,59,1151000,68,1946000,-9,-795000,Douglas County,Douglas County-Linn County-OR
1648,Douglas County-Clark County-NV-1819,"Clark County, NV",1819,2018,2019,49,842000,43,1152000,6,-310000,Douglas County,Douglas County-Clark County-NV
1653,Hood River County-Multnomah County-OR-1819,"Multnomah County, OR",1819,2018,2019,194,11299000,131,5466000,63,5833000,Hood River County,Hood River County-Multnomah County-OR
1654,Hood River County-Wasco County-OR-1819,"Wasco County, OR",1819,2018,2019,141,3690000,286,6278000,-145,-2588000,Hood River County,Hood River County-Wasco County-OR
1655,Hood River County-Klickitat County-WA-1819,"Klickitat County, WA",1819,2018,2019,130,2489000,139,6942000,-9,-4453000,Hood River County,Hood River County-Klickitat County-WA
1656,Hood River County-Washington County-OR-1819,"Washington County, OR",1819,2018,2019,52,2266000,34,1034000,18,1232000,Hood River County,Hood River County-Washington County-OR
1657,Hood River County-Clackamas County-OR-1819,"Clackamas County, OR",1819,2018,2019,54,1492000,36,1306000,18,186000,Hood River County,Hood River County-Clackamas County-OR
1658,Hood River County-Clark County-WA-1819,"Clark County, WA",1819,2018,2019,49,1494000,62,1808000,-13,-314000,Hood River County,Hood River County-Clark County-WA
1660,Jackson County-Josephine County-OR-1819,"Josephine County, OR",1819,2018,2019,986,23893000,956,21167000,30,2726000,Jackson County,Jackson County-Josephine County-OR
1661,Jackson County-Multnomah County-OR-1819,"Multnomah County, OR",1819,2018,2019,265,8686000,293,9642000,-28,-956000,Jackson County,Jackson County-Multnomah County-OR
1662,Jackson County-Lane County-OR-1819,"Lane County, OR",1819,2018,2019,255,7944000,337,9703000,-82,-1759000,Jackson County,Jackson County-Lane County-OR
1663,Jackson County-Los Angeles County-CA-1819,"Los Angeles County, CA",1819,2018,2019,273,8913000,128,5507000,145,3406000,Jackson County,Jackson County-Los Angeles County-CA
1664,Jackson County-Klamath County-OR-1819,"Klamath County, OR",1819,2018,2019,266,8831000,190,3481000,76,5350000,Jackson County,Jackson County-Klamath County-OR
1665,Jackson County-Washington County-OR-1819,"Washington County, OR",1819,2018,2019,201,5731000,210,6033000,-9,-302000,Jackson County,Jackson County-Washington County-OR
1666,Jackson County-San Diego County-CA-1819,"San Diego County, CA",1819,2018,2019,177,5915000,78,1852000,99,4063000,Jackson County,Jackson County-San Diego County-CA
1667,Jackson County-Deschutes County-OR-1819,"Deschutes County, OR",1819,2018,2019,139,5469000,225,15278000,-86,-9809000,Jackson County,Jackson County-Deschutes County-OR
1668,Jackson County-Siskiyou County-CA-1819,"Siskiyou County, CA",1819,2018,2019,146,6183000,70,1493000,76,4690000,Jackson County,Jackson County-Siskiyou County-CA
1669,Jackson County-Alameda County-CA-1819,"Alameda County, CA",1819,2018,2019,137,8477000,37,1418000,100,7059000,Jackson County,Jackson County-Alameda County-CA
1670,Jackson County-Douglas County-OR-1819,"Douglas County, OR",1819,2018,2019,149,3664000,157,3300000,-8,364000,Jackson County,Jackson County-Douglas County-OR
1671,Jackson County-Maricopa County-AZ-1819,"Maricopa County, AZ",1819,2018,2019,147,4468000,199,6279000,-52,-1811000,Jackson County,Jackson County-Maricopa County-AZ
1672,Jackson County-Shasta County-CA-1819,"Shasta County, CA",1819,2018,2019,121,3201000,50,1157000,71,2044000,Jackson County,Jackson County-Shasta County-CA
1673,Jackson County-Sacramento County-CA-1819,"Sacramento County, CA",1819,2018,2019,131,5118000,73,2332000,58,2786000,Jackson County,Jackson County-Sacramento County-CA
1674,Jackson County-Clackamas County-OR-1819,"Clackamas County, OR",1819,2018,2019,113,4840000,114,3861000,-1,979000,Jackson County,Jackson County-Clackamas County-OR
1675,Jackson County-Orange County-CA-1819,"Orange County, CA",1819,2018,2019,128,4520000,85,3033000,43,1487000,Jackson County,Jackson County-Orange County-CA
1676,Jackson County-Contra Costa County-CA-1819,"Contra Costa County, CA",1819,2018,2019,127,5092000,29,872000,98,4220000,Jackson County,Jackson County-Contra Costa County-CA
1677,Jackson County-Clark County-NV-1819,"Clark County, NV",1819,2018,2019,128,4069000,91,4621000,37,-552000,Jackson County,Jackson County-Clark County-NV
1678,Jackson County-King County-WA-1819,"King County, WA",1819,2018,2019,107,6768000,111,4398000,-4,2370000,Jackson County,Jackson County-King County-WA
1679,Jackson County-Curry County-OR-1819,"Curry County, OR",1819,2018,2019,107,2956000,88,2536000,19,420000,Jackson County,Jackson County-Curry County-OR
1680,Jackson County-Marion County-OR-1819,"Marion County, OR",1819,2018,2019,105,3058000,140,3850000,-35,-792000,Jackson County,Jackson County-Marion County-OR
1681,Jackson County-Sonoma County-CA-1819,"Sonoma County, CA",1819,2018,2019,96,4109000,44,1276000,52,2833000,Jackson County,Jackson County-Sonoma County-CA
1682,Jackson County-Coos County-OR-1819,"Coos County, OR",1819,2018,2019,84,2238000,111,2161000,-27,77000,Jackson County,Jackson County-Coos County-OR
1683,Jackson County-Riverside County-CA-1819,"Riverside County, CA",1819,2018,2019,85,2703000,52,2669000,33,34000,Jackson County,Jackson County-Riverside County-CA
1684,Jackson County-Benton County-OR-1819,"Benton County, OR",1819,2018,2019,57,1433000,78,2188000,-21,-755000,Jackson County,Jackson County-Benton County-OR
1685,Jackson County-Clark County-WA-1819,"Clark County, WA",1819,2018,2019,80,2606000,98,4677000,-18,-2071000,Jackson County,Jackson County-Clark County-WA
1686,Jackson County-Pierce County-WA-1819,"Pierce County, WA",1819,2018,2019,48,1835000,51,2414000,-3,-579000,Jackson County,Jackson County-Pierce County-WA
1687,Jackson County-Washoe County-NV-1819,"Washoe County, NV",1819,2018,2019,55,1696000,42,1567000,13,129000,Jackson County,Jackson County-Washoe County-NV
1688,Jackson County-Linn County-OR-1819,"Linn County, OR",1819,2018,2019,45,1310000,76,1869000,-31,-559000,Jackson County,Jackson County-Linn County-OR
1689,Jackson County-Ada County-ID-1819,"Ada County, ID",1819,2018,2019,44,1098000,72,3802000,-28,-2704000,Jackson County,Jackson County-Ada County-ID
1690,Jackson County-Snohomish County-WA-1819,"Snohomish County, WA",1819,2018,2019,40,1613000,38,916000,2,697000,Jackson County,Jackson County-Snohomish County-WA
1691,Jackson County-San Francisco County-CA-1819,"San Francisco County, CA",1819,2018,2019,29,2204000,35,2211000,-6,-7000,Jackson County,Jackson County-San Francisco County-CA
1693,Jefferson County-Deschutes County-OR-1819,"Deschutes County, OR",1819,2018,2019,586,14367000,341,7497000,245,6870000,Jefferson County,Jefferson County-Deschutes County-OR
1694,Jefferson County-Crook County-OR-1819,"Crook County, OR",1819,2018,2019,112,1854000,69,1344000,43,510000,Jefferson County,Jefferson County-Crook County-OR
1695,Jefferson County-Clackamas County-OR-1819,"Clackamas County, OR",1819,2018,2019,72,2776000,47,1059000,25,1717000,Jefferson County,Jefferson County-Clackamas County-OR
1696,Jefferson County-Marion County-OR-1819,"Marion County, OR",1819,2018,2019,57,1774000,46,1038000,11,736000,Jefferson County,Jefferson County-Marion County-OR
1698,Josephine County-Jackson County-OR-1819,"Jackson County, OR",1819,2018,2019,956,21167000,986,23893000,-30,-2726000,Josephine County,Josephine County-Jackson County-OR
1699,Josephine County-Douglas County-OR-1819,"Douglas County, OR",1819,2018,2019,133,2926000,133,2514000,0,412000,Josephine County,Josephine County-Douglas County-OR
1700,Josephine County-Lane County-OR-1819,"Lane County, OR",1819,2018,2019,108,2266000,152,3517000,-44,-1251000,Josephine County,Josephine County-Lane County-OR
1701,Josephine County-Klamath County-OR-1819,"Klamath County, OR",1819,2018,2019,78,1479000,55,937000,23,542000,Josephine County,Josephine County-Klamath County-OR
1702,Josephine County-Multnomah County-OR-1819,"Multnomah County, OR",1819,2018,2019,67,2423000,64,1848000,3,575000,Josephine County,Josephine County-Multnomah County-OR
1703,Josephine County-Curry County-OR-1819,"Curry County, OR",1819,2018,2019,44,1754000,46,1057000,-2,697000,Josephine County,Josephine County-Curry County-OR
1704,Josephine County-San Diego County-CA-1819,"San Diego County, CA",1819,2018,2019,49,2493000,41,1209000,8,1284000,Josephine County,Josephine County-San Diego County-CA
1705,Josephine County-Deschutes County-OR-1819,"Deschutes County, OR",1819,2018,2019,56,1711000,42,1283000,14,428000,Josephine County,Josephine County-Deschutes County-OR
1706,Josephine County-Washington County-OR-1819,"Washington County, OR",1819,2018,2019,40,1197000,53,1626000,-13,-429000,Josephine County,Josephine County-Washington County-OR
1707,Josephine County-Clark County-NV-1819,"Clark County, NV",1819,2018,2019,53,1756000,41,1091000,12,665000,Josephine County,Josephine County-Clark County-NV
1708,Josephine County-Maricopa County-AZ-1819,"Maricopa County, AZ",1819,2018,2019,63,1370000,79,3626000,-16,-2256000,Josephine County,Josephine County-Maricopa County-AZ
1709,Josephine County-Coos County-OR-1819,"Coos County, OR",1819,2018,2019,58,1470000,68,1779000,-10,-309000,Josephine County,Josephine County-Coos County-OR
1711,Klamath County-Jackson County-OR-1819,"Jackson County, OR",1819,2018,2019,190,3481000,266,8831000,-76,-5350000,Klamath County,Klamath County-Jackson County-OR
1712,Klamath County-Deschutes County-OR-1819,"Deschutes County, OR",1819,2018,2019,192,4150000,174,4222000,18,-72000,Klamath County,Klamath County-Deschutes County-OR
1713,Klamath County-Lane County-OR-1819,"Lane County, OR",1819,2018,2019,100,2518000,128,3126000,-28,-608000,Klamath County,Klamath County-Lane County-OR
1714,Klamath County-Clackamas County-OR-1819,"Clackamas County, OR",1819,2018,2019,67,2716000,32,824000,35,1892000,Klamath County,Klamath County-Clackamas County-OR
1715,Klamath County-Multnomah County-OR-1819,"Multnomah County, OR",1819,2018,2019,65,1837000,43,805000,22,1032000,Klamath County,Klamath County-Multnomah County-OR
1716,Klamath County-Siskiyou County-CA-1819,"Siskiyou County, CA",1819,2018,2019,73,1426000,37,589000,36,837000,Klamath County,Klamath County-Siskiyou County-CA
1717,Klamath County-Linn County-OR-1819,"Linn County, OR",1819,2018,2019,60,1648000,34,872000,26,776000,Klamath County,Klamath County-Linn County-OR
1718,Klamath County-Marion County-OR-1819,"Marion County, OR",1819,2018,2019,64,1732000,65,1559000,-1,173000,Klamath County,Klamath County-Marion County-OR
1719,Klamath County-Josephine County-OR-1819,"Josephine County, OR",1819,2018,2019,55,937000,78,1479000,-23,-542000,Klamath County,Klamath County-Josephine County-OR
1720,Klamath County-Washington County-OR-1819,"Washington County, OR",1819,2018,2019,70,1369000,62,1767000,8,-398000,Klamath County,Klamath County-Washington County-OR
1721,Klamath County-Douglas County-OR-1819,"Douglas County, OR",1819,2018,2019,45,1060000,58,1032000,-13,28000,Klamath County,Klamath County-Douglas County-OR
1724,Lane County-Multnomah County-OR-1819,"Multnomah County, OR",1819,2018,2019,563,18722000,812,27850000,-249,-9128000,Lane County,Lane County-Multnomah County-OR
1725,Lane County-Linn County-OR-1819,"Linn County, OR",1819,2018,2019,621,15489000,860,20469000,-239,-4980000,Lane County,Lane County-Linn County-OR
1726,Lane County-Douglas County-OR-1819,"Douglas County, OR",1819,2018,2019,452,8067000,503,9239000,-51,-1172000,Lane County,Lane County-Douglas County-OR
1727,Lane County-Benton County-OR-1819,"Benton County, OR",1819,2018,2019,356,9651000,349,9395000,7,256000,Lane County,Lane County-Benton County-OR
1728,Lane County-Washington County-OR-1819,"Washington County, OR",1819,2018,2019,391,12665000,476,15008000,-85,-2343000,Lane County,Lane County-Washington County-OR
1729,Lane County-Marion County-OR-1819,"Marion County, OR",1819,2018,2019,412,11158000,419,10819000,-7,339000,Lane County,Lane County-Marion County-OR
1730,Lane County-Deschutes County-OR-1819,"Deschutes County, OR",1819,2018,2019,359,9074000,497,17680000,-138,-8606000,Lane County,Lane County-Deschutes County-OR
1731,Lane County-Jackson County-OR-1819,"Jackson County, OR",1819,2018,2019,337,9703000,255,7944000,82,1759000,Lane County,Lane County-Jackson County-OR
1732,Lane County-Los Angeles County-CA-1819,"Los Angeles County, CA",1819,2018,2019,341,12254000,173,5602000,168,6652000,Lane County,Lane County-Los Angeles County-CA
1733,Lane County-Clackamas County-OR-1819,"Clackamas County, OR",1819,2018,2019,283,8892000,365,13604000,-82,-4712000,Lane County,Lane County-Clackamas County-OR
1734,Lane County-King County-WA-1819,"King County, WA",1819,2018,2019,236,10540000,266,10598000,-30,-58000,Lane County,Lane County-King County-WA
1735,Lane County-Coos County-OR-1819,"Coos County, OR",1819,2018,2019,256,6848000,228,5150000,28,1698000,Lane County,Lane County-Coos County-OR
1736,Lane County-San Diego County-CA-1819,"San Diego County, CA",1819,2018,2019,244,7693000,154,4244000,90,3449000,Lane County,Lane County-San Diego County-CA
1737,Lane County-Maricopa County-AZ-1819,"Maricopa County, AZ",1819,2018,2019,241,6516000,248,13047000,-7,-6531000,Lane County,Lane County-Maricopa County-AZ
1738,Lane County-Orange County-CA-1819,"Orange County, CA",1819,2018,2019,212,8666000,88,3717000,124,4949000,Lane County,Lane County-Orange County-CA
1739,Lane County-Lincoln County-OR-1819,"Lincoln County, OR",1819,2018,2019,194,6040000,145,4099000,49,1941000,Lane County,Lane County-Lincoln County-OR
1740,Lane County-Clark County-WA-1819,"Clark County, WA",1819,2018,2019,179,4733000,246,10035000,-67,-5302000,Lane County,Lane County-Clark County-WA
1741,Lane County-Santa Clara County-CA-1819,"Santa Clara County, CA",1819,2018,2019,159,9659000,64,2375000,95,7284000,Lane County,Lane County-Santa Clara County-CA
1742,Lane County-Josephine County-OR-1819,"Josephine County, OR",1819,2018,2019,152,3517000,108,2266000,44,1251000,Lane County,Lane County-Josephine County-OR
1743,Lane County-Clark County-NV-1819,"Clark County, NV",1819,2018,2019,146,6843000,97,2243000,49,4600000,Lane County,Lane County-Clark County-NV
1744,Lane County-Alameda County-CA-1819,"Alameda County, CA",1819,2018,2019,151,8519000,36,1867000,115,6652000,Lane County,Lane County-Alameda County-CA
1745,Lane County-Riverside County-CA-1819,"Riverside County, CA",1819,2018,2019,141,3300000,79,1777000,62,1523000,Lane County,Lane County-Riverside County-CA
1746,Lane County-Klamath County-OR-1819,"Klamath County, OR",1819,2018,2019,128,3126000,100,2518000,28,608000,Lane County,Lane County-Klamath County-OR
1747,Lane County-Contra Costa County-CA-1819,"Contra Costa County, CA",1819,2018,2019,112,5448000,39,782000,73,4666000,Lane County,Lane County-Contra Costa County-CA
1748,Lane County-Pierce County-WA-1819,"Pierce County, WA",1819,2018,2019,117,4934000,109,3398000,8,1536000,Lane County,Lane County-Pierce County-WA
1749,Lane County-Sacramento County-CA-1819,"Sacramento County, CA",1819,2018,2019,120,3932000,77,2068000,43,1864000,Lane County,Lane County-Sacramento County-CA
1750,Lane County-Ada County-ID-1819,"Ada County, ID",1819,2018,2019,98,3737000,110,4013000,-12,-276000,Lane County,Lane County-Ada County-ID
1751,Lane County-Polk County-OR-1819,"Polk County, OR",1819,2018,2019,88,2748000,132,3593000,-44,-845000,Lane County,Lane County-Polk County-OR
1752,Lane County-Yamhill County-OR-1819,"Yamhill County, OR",1819,2018,2019,84,2783000,78,2392000,6,391000,Lane County,Lane County-Yamhill County-OR
1753,Lane County-San Bernardino County-CA-1819,"San Bernardino County, CA",1819,2018,2019,94,2096000,36,816000,58,1280000,Lane County,Lane County-San Bernardino County-CA
1754,Lane County-Ventura County-CA-1819,"Ventura County, CA",1819,2018,2019,76,2697000,29,1303000,47,1394000,Lane County,Lane County-Ventura County-CA
1755,Lane County-Travis County-TX-1819,"Travis County, TX",1819,2018,2019,69,2107000,47,1828000,22,279000,Lane County,Lane County-Travis County-TX
1756,Lane County-Snohomish County-WA-1819,"Snohomish County, WA",1819,2018,2019,67,2545000,59,1649000,8,896000,Lane County,Lane County-Snohomish County-WA
1757,Lane County-Pima County-AZ-1819,"Pima County, AZ",1819,2018,2019,63,2218000,70,2105000,-7,113000,Lane County,Lane County-Pima County-AZ
1758,Lane County-Salt Lake County-UT-1819,"Salt Lake County, UT",1819,2018,2019,60,1668000,84,2617000,-24,-949000,Lane County,Lane County-Salt Lake County-UT
1759,Lane County-Honolulu County-HI-1819,"Honolulu County, HI",1819,2018,2019,68,2002000,51,1392000,17,610000,Lane County,Lane County-Honolulu County-HI
1760,Lane County-San Francisco County-CA-1819,"San Francisco County, CA",1819,2018,2019,50,4717000,35,1702000,15,3015000,Lane County,Lane County-San Francisco County-CA
1761,Lane County-Santa Cruz County-CA-1819,"Santa Cruz County, CA",1819,2018,2019,65,2511000,34,1030000,31,1481000,Lane County,Lane County-Santa Cruz County-CA
1762,Lane County-Cook County-IL-1819,"Cook County, IL",1819,2018,2019,48,1827000,39,1456000,9,371000,Lane County,Lane County-Cook County-IL
1763,Lane County-Spokane County-WA-1819,"Spokane County, WA",1819,2018,2019,60,1694000,73,1916000,-13,-222000,Lane County,Lane County-Spokane County-WA
1764,Lane County-Thurston County-WA-1819,"Thurston County, WA",1819,2018,2019,60,1538000,74,2514000,-14,-976000,Lane County,Lane County-Thurston County-WA
1765,Lane County-Clatsop County-OR-1819,"Clatsop County, OR",1819,2018,2019,47,1228000,35,715000,12,513000,Lane County,Lane County-Clatsop County-OR
1766,Lane County-Washoe County-NV-1819,"Washoe County, NV",1819,2018,2019,50,1769000,74,2311000,-24,-542000,Lane County,Lane County-Washoe County-NV
1767,Lane County-Humboldt County-CA-1819,"Humboldt County, CA",1819,2018,2019,52,1842000,33,627000,19,1215000,Lane County,Lane County-Humboldt County-CA
1768,Lane County-Placer County-CA-1819,"Placer County, CA",1819,2018,2019,54,1477000,35,1261000,19,216000,Lane County,Lane County-Placer County-CA
1769,Lane County-Umatilla County-OR-1819,"Umatilla County, OR",1819,2018,2019,47,873000,30,568000,17,305000,Lane County,Lane County-Umatilla County-OR
1770,Lane County-Harris County-TX-1819,"Harris County, TX",1819,2018,2019,38,1178000,50,983000,-12,195000,Lane County,Lane County-Harris County-TX
1771,Lane County-Canyon County-ID-1819,"Canyon County, ID",1819,2018,2019,47,683000,39,978000,8,-295000,Lane County,Lane County-Canyon County-ID
1772,Lane County-Whatcom County-WA-1819,"Whatcom County, WA",1819,2018,2019,34,1602000,43,1786000,-9,-184000,Lane County,Lane County-Whatcom County-WA
1774,Lincoln County-Multnomah County-OR-1819,"Multnomah County, OR",1819,2018,2019,158,5722000,122,3253000,36,2469000,Lincoln County,Lincoln County-Multnomah County-OR
1775,Lincoln County-Lane County-OR-1819,"Lane County, OR",1819,2018,2019,145,4099000,194,6040000,-49,-1941000,Lincoln County,Lincoln County-Lane County-OR
1776,Lincoln County-Marion County-OR-1819,"Marion County, OR",1819,2018,2019,145,4096000,149,4018000,-4,78000,Lincoln County,Lincoln County-Marion County-OR
1777,Lincoln County-Washington County-OR-1819,"Washington County, OR",1819,2018,2019,121,5724000,96,3070000,25,2654000,Lincoln County,Lincoln County-Washington County-OR
1778,Lincoln County-Clackamas County-OR-1819,"Clackamas County, OR",1819,2018,2019,129,4545000,85,3305000,44,1240000,Lincoln County,Lincoln County-Clackamas County-OR
1779,Lincoln County-Linn County-OR-1819,"Linn County, OR",1819,2018,2019,113,2421000,132,2838000,-19,-417000,Lincoln County,Lincoln County-Linn County-OR
1780,Lincoln County-Benton County-OR-1819,"Benton County, OR",1819,2018,2019,79,3683000,120,4022000,-41,-339000,Lincoln County,Lincoln County-Benton County-OR
1781,Lincoln County-Yamhill County-OR-1819,"Yamhill County, OR",1819,2018,2019,77,2300000,51,1619000,26,681000,Lincoln County,Lincoln County-Yamhill County-OR
1782,Lincoln County-Deschutes County-OR-1819,"Deschutes County, OR",1819,2018,2019,68,1729000,97,2236000,-29,-507000,Lincoln County,Lincoln County-Deschutes County-OR
1783,Lincoln County-Polk County-OR-1819,"Polk County, OR",1819,2018,2019,77,1921000,92,2832000,-15,-911000,Lincoln County,Lincoln County-Polk County-OR
1784,Lincoln County-Maricopa County-AZ-1819,"Maricopa County, AZ",1819,2018,2019,47,1933000,62,2083000,-15,-150000,Lincoln County,Lincoln County-Maricopa County-AZ
1785,Lincoln County-Clark County-WA-1819,"Clark County, WA",1819,2018,2019,35,1094000,72,1312000,-37,-218000,Lincoln County,Lincoln County-Clark County-WA
1786,Lincoln County-Tillamook County-OR-1819,"Tillamook County, OR",1819,2018,2019,35,964000,47,1588000,-12,-624000,Lincoln County,Lincoln County-Tillamook County-OR
1788,Linn County-Benton County-OR-1819,"Benton County, OR",1819,2018,2019,1220,37122000,1047,29731000,173,7391000,Linn County,Linn County-Benton County-OR
1789,Linn County-Marion County-OR-1819,"Marion County, OR",1819,2018,2019,1223,32272000,1013,26346000,210,5926000,Linn County,Linn County-Marion County-OR
1790,Linn County-Lane County-OR-1819,"Lane County, OR",1819,2018,2019,860,20469000,621,15489000,239,4980000,Linn County,Linn County-Lane County-OR
1791,Linn County-Polk County-OR-1819,"Polk County, OR",1819,2018,2019,238,6474000,220,5383000,18,1091000,Linn County,Linn County-Polk County-OR
1792,Linn County-Washington County-OR-1819,"Washington County, OR",1819,2018,2019,186,5688000,151,3477000,35,2211000,Linn County,Linn County-Washington County-OR
1793,Linn County-Multnomah County-OR-1819,"Multnomah County, OR",1819,2018,2019,139,4131000,140,3401000,-1,730000,Linn County,Linn County-Multnomah County-OR
1794,Linn County-Clackamas County-OR-1819,"Clackamas County, OR",1819,2018,2019,154,4172000,127,4055000,27,117000,Linn County,Linn County-Clackamas County-OR
1795,Linn County-Lincoln County-OR-1819,"Lincoln County, OR",1819,2018,2019,132,2838000,113,2421000,19,417000,Linn County,Linn County-Lincoln County-OR
1796,Linn County-Deschutes County-OR-1819,"Deschutes County, OR",1819,2018,2019,135,3548000,142,3689000,-7,-141000,Linn County,Linn County-Deschutes County-OR
1797,Linn County-Yamhill County-OR-1819,"Yamhill County, OR",1819,2018,2019,95,2390000,49,1098000,46,1292000,Linn County,Linn County-Yamhill County-OR
1798,Linn County-Los Angeles County-CA-1819,"Los Angeles County, CA",1819,2018,2019,71,2293000,34,1501000,37,792000,Linn County,Linn County-Los Angeles County-CA
1799,Linn County-Clark County-WA-1819,"Clark County, WA",1819,2018,2019,81,2641000,56,2066000,25,575000,Linn County,Linn County-Clark County-WA
1800,Linn County-Maricopa County-AZ-1819,"Maricopa County, AZ",1819,2018,2019,66,1785000,68,1513000,-2,272000,Linn County,Linn County-Maricopa County-AZ
1801,Linn County-Jackson County-OR-1819,"Jackson County, OR",1819,2018,2019,76,1869000,45,1310000,31,559000,Linn County,Linn County-Jackson County-OR
1802,Linn County-Douglas County-OR-1819,"Douglas County, OR",1819,2018,2019,68,1946000,59,1151000,9,795000,Linn County,Linn County-Douglas County-OR
1803,Linn County-King County-WA-1819,"King County, WA",1819,2018,2019,53,3297000,48,1482000,5,1815000,Linn County,Linn County-King County-WA
1804,Linn County-Pierce County-WA-1819,"Pierce County, WA",1819,2018,2019,48,1421000,46,1178000,2,243000,Linn County,Linn County-Pierce County-WA
1805,Linn County-Riverside County-CA-1819,"Riverside County, CA",1819,2018,2019,41,1348000,29,641000,12,707000,Linn County,Linn County-Riverside County-CA
1806,Linn County-Klamath County-OR-1819,"Klamath County, OR",1819,2018,2019,34,872000,60,1648000,-26,-776000,Linn County,Linn County-Klamath County-OR
1807,Linn County-Coos County-OR-1819,"Coos County, OR",1819,2018,2019,40,759000,47,793000,-7,-34000,Linn County,Linn County-Coos County-OR
1809,Malheur County-Payette County-ID-1819,"Payette County, ID",1819,2018,2019,304,5067000,308,5145000,-4,-78000,Malheur County,Malheur County-Payette County-ID
1810,Malheur County-Canyon County-ID-1819,"Canyon County, ID",1819,2018,2019,243,3014000,213,4218000,30,-1204000,Malheur County,Malheur County-Canyon County-ID
1811,Malheur County-Ada County-ID-1819,"Ada County, ID",1819,2018,2019,125,2408000,106,3062000,19,-654000,Malheur County,Malheur County-Ada County-ID
1812,Malheur County-Washington County-ID-1819,"Washington County, ID",1819,2018,2019,57,546000,54,793000,3,-247000,Malheur County,Malheur County-Washington County-ID
1814,Marion County-Polk County-OR-1819,"Polk County, OR",1819,2018,2019,2111,57545000,2499,64463000,-388,-6918000,Marion County,Marion County-Polk County-OR
1815,Marion County-Clackamas County-OR-1819,"Clackamas County, OR",1819,2018,2019,1709,49746000,1252,38978000,457,10768000,Marion County,Marion County-Clackamas County-OR
1816,Marion County-Washington County-OR-1819,"Washington County, OR",1819,2018,2019,1175,34227000,925,27670000,250,6557000,Marion County,Marion County-Washington County-OR
1817,Marion County-Linn County-OR-1819,"Linn County, OR",1819,2018,2019,1013,26346000,1223,32272000,-210,-5926000,Marion County,Marion County-Linn County-OR
1818,Marion County-Multnomah County-OR-1819,"Multnomah County, OR",1819,2018,2019,881,24045000,764,23068000,117,977000,Marion County,Marion County-Multnomah County-OR
1819,Marion County-Yamhill County-OR-1819,"Yamhill County, OR",1819,2018,2019,548,13814000,388,10015000,160,3799000,Marion County,Marion County-Yamhill County-OR
1820,Marion County-Lane County-OR-1819,"Lane County, OR",1819,2018,2019,419,10819000,412,11158000,7,-339000,Marion County,Marion County-Lane County-OR
1821,Marion County-Benton County-OR-1819,"Benton County, OR",1819,2018,2019,245,8643000,252,7230000,-7,1413000,Marion County,Marion County-Benton County-OR
1822,Marion County-Clark County-WA-1819,"Clark County, WA",1819,2018,2019,274,7399000,305,9116000,-31,-1717000,Marion County,Marion County-Clark County-WA
1823,Marion County-Los Angeles County-CA-1819,"Los Angeles County, CA",1819,2018,2019,243,7160000,97,2290000,146,4870000,Marion County,Marion County-Los Angeles County-CA
1824,Marion County-Deschutes County-OR-1819,"Deschutes County, OR",1819,2018,2019,226,5276000,339,18724000,-113,-13448000,Marion County,Marion County-Deschutes County-OR
1825,Marion County-Lincoln County-OR-1819,"Lincoln County, OR",1819,2018,2019,149,4018000,145,4096000,4,-78000,Marion County,Marion County-Lincoln County-OR
1826,Marion County-Maricopa County-AZ-1819,"Maricopa County, AZ",1819,2018,2019,156,5296000,220,7972000,-64,-2676000,Marion County,Marion County-Maricopa County-AZ
1827,Marion County-King County-WA-1819,"King County, WA",1819,2018,2019,156,4108000,121,4425000,35,-317000,Marion County,Marion County-King County-WA
1828,Marion County-Jackson County-OR-1819,"Jackson County, OR",1819,2018,2019,140,3850000,105,3058000,35,792000,Marion County,Marion County-Jackson County-OR
1829,Marion County-San Diego County-CA-1819,"San Diego County, CA",1819,2018,2019,129,3891000,65,1182000,64,2709000,Marion County,Marion County-San Diego County-CA
1830,Marion County-Pierce County-WA-1819,"Pierce County, WA",1819,2018,2019,120,2404000,81,2689000,39,-285000,Marion County,Marion County-Pierce County-WA
1831,Marion County-Orange County-CA-1819,"Orange County, CA",1819,2018,2019,106,3358000,38,901000,68,2457000,Marion County,Marion County-Orange County-CA
1832,Marion County-Douglas County-OR-1819,"Douglas County, OR",1819,2018,2019,101,3104000,91,2338000,10,766000,Marion County,Marion County-Douglas County-OR
1833,Marion County-Clark County-NV-1819,"Clark County, NV",1819,2018,2019,96,2236000,102,2879000,-6,-643000,Marion County,Marion County-Clark County-NV
1834,Marion County-Riverside County-CA-1819,"Riverside County, CA",1819,2018,2019,96,3101000,60,2017000,36,1084000,Marion County,Marion County-Riverside County-CA
1835,Marion County-Sacramento County-CA-1819,"Sacramento County, CA",1819,2018,2019,96,2266000,63,1487000,33,779000,Marion County,Marion County-Sacramento County-CA
1836,Marion County-San Bernardino County-CA-1819,"San Bernardino County, CA",1819,2018,2019,99,2429000,42,787000,57,1642000,Marion County,Marion County-San Bernardino County-CA
1837,Marion County-Coos County-OR-1819,"Coos County, OR",1819,2018,2019,68,1836000,57,1428000,11,408000,Marion County,Marion County-Coos County-OR
1838,Marion County-Snohomish County-WA-1819,"Snohomish County, WA",1819,2018,2019,81,2259000,50,1446000,31,813000,Marion County,Marion County-Snohomish County-WA
1839,Marion County-Klamath County-OR-1819,"Klamath County, OR",1819,2018,2019,65,1559000,64,1732000,1,-173000,Marion County,Marion County-Klamath County-OR
1840,Marion County-Honolulu County-HI-1819,"Honolulu County, HI",1819,2018,2019,72,1603000,47,931000,25,672000,Marion County,Marion County-Honolulu County-HI
1841,Marion County-Ada County-ID-1819,"Ada County, ID",1819,2018,2019,69,1261000,62,1718000,7,-457000,Marion County,Marion County-Ada County-ID
1842,Marion County-Pima County-AZ-1819,"Pima County, AZ",1819,2018,2019,59,1505000,59,2477000,0,-972000,Marion County,Marion County-Pima County-AZ
1843,Marion County-Jefferson County-OR-1819,"Jefferson County, OR",1819,2018,2019,46,1038000,57,1774000,-11,-736000,Marion County,Marion County-Jefferson County-OR
1844,Marion County-Spokane County-WA-1819,"Spokane County, WA",1819,2018,2019,49,869000,72,1973000,-23,-1104000,Marion County,Marion County-Spokane County-WA
1845,Marion County-Cowlitz County-WA-1819,"Cowlitz County, WA",1819,2018,2019,36,804000,49,914000,-13,-110000,Marion County,Marion County-Cowlitz County-WA
1846,Marion County-Clatsop County-OR-1819,"Clatsop County, OR",1819,2018,2019,44,966000,50,1140000,-6,-174000,Marion County,Marion County-Clatsop County-OR
1848,Morrow County-Umatilla County-OR-1819,"Umatilla County, OR",1819,2018,2019,305,6184000,254,6123000,51,61000,Morrow County,Morrow County-Umatilla County-OR
1850,Multnomah County-Washington County-OR-1819,"Washington County, OR",1819,2018,2019,6320,315447000,7018,342959000,-698,-27512000,Multnomah County,Multnomah County-Washington County-OR
1851,Multnomah County-Clackamas County-OR-1819,"Clackamas County, OR",1819,2018,2019,6267,230740000,8956,375923000,-2689,-145183000,Multnomah County,Multnomah County-Clackamas County-OR
1852,Multnomah County-Clark County-WA-1819,"Clark County, WA",1819,2018,2019,2808,103561000,4782,183091000,-1974,-79530000,Multnomah County,Multnomah County-Clark County-WA
1853,Multnomah County-Los Angeles County-CA-1819,"Los Angeles County, CA",1819,2018,2019,1299,70023000,801,37831000,498,32192000,Multnomah County,Multnomah County-Los Angeles County-CA
1854,Multnomah County-King County-WA-1819,"King County, WA",1819,2018,2019,1125,64214000,1212,73644000,-87,-9430000,Multnomah County,Multnomah County-King County-WA
1855,Multnomah County-Lane County-OR-1819,"Lane County, OR",1819,2018,2019,812,27850000,563,18722000,249,9128000,Multnomah County,Multnomah County-Lane County-OR
1856,Multnomah County-Marion County-OR-1819,"Marion County, OR",1819,2018,2019,764,23068000,881,24045000,-117,-977000,Multnomah County,Multnomah County-Marion County-OR
1857,Multnomah County-San Diego County-CA-1819,"San Diego County, CA",1819,2018,2019,574,25053000,410,17995000,164,7058000,Multnomah County,Multnomah County-San Diego County-CA
1858,Multnomah County-Alameda County-CA-1819,"Alameda County, CA",1819,2018,2019,630,43728000,244,13354000,386,30374000,Multnomah County,Multnomah County-Alameda County-CA
1859,Multnomah County-San Francisco County-CA-1819,"San Francisco County, CA",1819,2018,2019,619,68903000,231,31516000,388,37387000,Multnomah County,Multnomah County-San Francisco County-CA
1860,Multnomah County-Maricopa County-AZ-1819,"Maricopa County, AZ",1819,2018,2019,499,21510000,573,32566000,-74,-11056000,Multnomah County,Multnomah County-Maricopa County-AZ
1861,Multnomah County-Santa Clara County-CA-1819,"Santa Clara County, CA",1819,2018,2019,513,56861000,234,17424000,279,39437000,Multnomah County,Multnomah County-Santa Clara County-CA
1862,Multnomah County-Orange County-CA-1819,"Orange County, CA",1819,2018,2019,394,17981000,263,21523000,131,-3542000,Multnomah County,Multnomah County-Orange County-CA
1863,Multnomah County-Cook County-IL-1819,"Cook County, IL",1819,2018,2019,404,26144000,211,10302000,193,15842000,Multnomah County,Multnomah County-Cook County-IL
1864,Multnomah County-Benton County-OR-1819,"Benton County, OR",1819,2018,2019,371,11908000,224,10017000,147,1891000,Multnomah County,Multnomah County-Benton County-OR
1865,Multnomah County-Deschutes County-OR-1819,"Deschutes County, OR",1819,2018,2019,387,18930000,738,53218000,-351,-34288000,Multnomah County,Multnomah County-Deschutes County-OR
1866,Multnomah County-Kings County-NY-1819,"Kings County, NY",1819,2018,2019,320,26139000,207,11050000,113,15089000,Multnomah County,Multnomah County-Kings County-NY
1867,Multnomah County-Jackson County-OR-1819,"Jackson County, OR",1819,2018,2019,293,9642000,265,8686000,28,956000,Multnomah County,Multnomah County-Jackson County-OR
1868,Multnomah County-Clark County-NV-1819,"Clark County, NV",1819,2018,2019,332,11739000,355,33608000,-23,-21869000,Multnomah County,Multnomah County-Clark County-NV
1869,Multnomah County-Yamhill County-OR-1819,"Yamhill County, OR",1819,2018,2019,283,10650000,295,13284000,-12,-2634000,Multnomah County,Multnomah County-Yamhill County-OR
1870,Multnomah County-Pierce County-WA-1819,"Pierce County, WA",1819,2018,2019,289,11949000,252,11074000,37,875000,Multnomah County,Multnomah County-Pierce County-WA
1871,Multnomah County-Columbia County-OR-1819,"Columbia County, OR",1819,2018,2019,268,9116000,550,20298000,-282,-11182000,Multnomah County,Multnomah County-Columbia County-OR
1872,Multnomah County-Denver County-CO-1819,"Denver County, CO",1819,2018,2019,194,26508000,198,12624000,-4,13884000,Multnomah County,Multnomah County-Denver County-CO
1873,Multnomah County-Travis County-TX-1819,"Travis County, TX",1819,2018,2019,224,20029000,207,10562000,17,9467000,Multnomah County,Multnomah County-Travis County-TX
1874,Multnomah County-San Mateo County-CA-1819,"San Mateo County, CA",1819,2018,2019,227,18622000,86,8907000,141,9715000,Multnomah County,Multnomah County-San Mateo County-CA
1875,Multnomah County-Honolulu County-HI-1819,"Honolulu County, HI",1819,2018,2019,232,9201000,198,8671000,34,530000,Multnomah County,Multnomah County-Honolulu County-HI
1876,Multnomah County-New York County-NY-1819,"New York County, NY",1819,2018,2019,191,25351000,156,12801000,35,12550000,Multnomah County,Multnomah County-New York County-NY
1877,Multnomah County-Sacramento County-CA-1819,"Sacramento County, CA",1819,2018,2019,217,8265000,183,7616000,34,649000,Multnomah County,Multnomah County-Sacramento County-CA
1878,Multnomah County-Salt Lake County-UT-1819,"Salt Lake County, UT",1819,2018,2019,208,9249000,141,5877000,67,3372000,Multnomah County,Multnomah County-Salt Lake County-UT
1879,Multnomah County-Contra Costa County-CA-1819,"Contra Costa County, CA",1819,2018,2019,193,10262000,85,3150000,108,7112000,Multnomah County,Multnomah County-Contra Costa County-CA
1880,Multnomah County-Hennepin County-MN-1819,"Hennepin County, MN",1819,2018,2019,168,11283000,143,10804000,25,479000,Multnomah County,Multnomah County-Hennepin County-MN
1881,Multnomah County-Thurston County-WA-1819,"Thurston County, WA",1819,2018,2019,173,6622000,145,5734000,28,888000,Multnomah County,Multnomah County-Thurston County-WA
1882,Multnomah County-Middlesex County-MA-1819,"Middlesex County, MA",1819,2018,2019,150,10108000,92,10533000,58,-425000,Multnomah County,Multnomah County-Middlesex County-MA
1883,Multnomah County-Harris County-TX-1819,"Harris County, TX",1819,2018,2019,171,7878000,130,4429000,41,3449000,Multnomah County,Multnomah County-Harris County-TX
1884,Multnomah County-Ada County-ID-1819,"Ada County, ID",1819,2018,2019,146,3768000,235,9068000,-89,-5300000,Multnomah County,Multnomah County-Ada County-ID
1885,Multnomah County-Riverside County-CA-1819,"Riverside County, CA",1819,2018,2019,155,7181000,174,14449000,-19,-7268000,Multnomah County,Multnomah County-Riverside County-CA
1886,Multnomah County-Snohomish County-WA-1819,"Snohomish County, WA",1819,2018,2019,168,5526000,179,7516000,-11,-1990000,Multnomah County,Multnomah County-Snohomish County-WA
1887,Multnomah County-San Bernardino County-CA-1819,"San Bernardino County, CA",1819,2018,2019,149,4047000,101,3053000,48,994000,Multnomah County,Multnomah County-San Bernardino County-CA
1888,Multnomah County-Sonoma County-CA-1819,"Sonoma County, CA",1819,2018,2019,142,5892000,58,2119000,84,3773000,Multnomah County,Multnomah County-Sonoma County-CA
1889,Multnomah County-District of Columbia-DC-1819,"District of Columbia, DC",1819,2018,2019,132,8655000,64,3554000,68,5101000,Multnomah County,Multnomah County-District of Columbia-DC
1890,Multnomah County-Spokane County-WA-1819,"Spokane County, WA",1819,2018,2019,141,4075000,227,8182000,-86,-4107000,Multnomah County,Multnomah County-Spokane County-WA
1891,Multnomah County-Clatsop County-OR-1819,"Clatsop County, OR",1819,2018,2019,154,5837000,239,21468000,-85,-15631000,Multnomah County,Multnomah County-Clatsop County-OR
1892,Multnomah County-Linn County-OR-1819,"Linn County, OR",1819,2018,2019,140,3401000,139,4131000,1,-730000,Multnomah County,Multnomah County-Linn County-OR
1893,Multnomah County-Dallas County-TX-1819,"Dallas County, TX",1819,2018,2019,138,8923000,77,4932000,61,3991000,Multnomah County,Multnomah County-Dallas County-TX
1894,Multnomah County-Cowlitz County-WA-1819,"Cowlitz County, WA",1819,2018,2019,154,4749000,337,9628000,-183,-4879000,Multnomah County,Multnomah County-Cowlitz County-WA
1895,Multnomah County-Polk County-OR-1819,"Polk County, OR",1819,2018,2019,132,3513000,150,4198000,-18,-685000,Multnomah County,Multnomah County-Polk County-OR
1896,Multnomah County-Hood River County-OR-1819,"Hood River County, OR",1819,2018,2019,131,5466000,194,11299000,-63,-5833000,Multnomah County,Multnomah County-Hood River County-OR
1897,Multnomah County-Suffolk County-MA-1819,"Suffolk County, MA",1819,2018,2019,123,8574000,58,4428000,65,4146000,Multnomah County,Multnomah County-Suffolk County-MA
1898,Multnomah County-Whatcom County-WA-1819,"Whatcom County, WA",1819,2018,2019,103,3331000,99,4211000,4,-880000,Multnomah County,Multnomah County-Whatcom County-WA
1899,Multnomah County-Pima County-AZ-1819,"Pima County, AZ",1819,2018,2019,127,7155000,173,6808000,-46,347000,Multnomah County,Multnomah County-Pima County-AZ
1900,Multnomah County-Philadelphia County-PA-1819,"Philadelphia County, PA",1819,2018,2019,114,6624000,103,4623000,11,2001000,Multnomah County,Multnomah County-Philadelphia County-PA
1901,Multnomah County-Marin County-CA-1819,"Marin County, CA",1819,2018,2019,120,13275000,59,6386000,61,6889000,Multnomah County,Multnomah County-Marin County-CA
1902,Multnomah County-Washoe County-NV-1819,"Washoe County, NV",1819,2018,2019,97,4052000,99,2965000,-2,1087000,Multnomah County,Multnomah County-Washoe County-NV
1903,Multnomah County-Bexar County-TX-1819,"Bexar County, TX",1819,2018,2019,122,8502000,55,3120000,67,5382000,Multnomah County,Multnomah County-Bexar County-TX
1904,Multnomah County-Santa Barbara County-CA-1819,"Santa Barbara County, CA",1819,2018,2019,95,3465000,51,3910000,44,-445000,Multnomah County,Multnomah County-Santa Barbara County-CA
1905,Multnomah County-Anchorage Municipality-AK-1819,"Anchorage Municipality, AK",1819,2018,2019,99,4227000,64,2668000,35,1559000,Multnomah County,Multnomah County-Anchorage Municipality-AK
1906,Multnomah County-Ventura County-CA-1819,"Ventura County, CA",1819,2018,2019,96,4025000,72,2631000,24,1394000,Multnomah County,Multnomah County-Ventura County-CA
1907,Multnomah County-Lincoln County-OR-1819,"Lincoln County, OR",1819,2018,2019,122,3253000,158,5722000,-36,-2469000,Multnomah County,Multnomah County-Lincoln County-OR
1908,Multnomah County-Franklin County-OH-1819,"Franklin County, OH",1819,2018,2019,92,4862000,67,1696000,25,3166000,Multnomah County,Multnomah County-Franklin County-OH
1909,Multnomah County-Bernalillo County-NM-1819,"Bernalillo County, NM",1819,2018,2019,104,5151000,73,2718000,31,2433000,Multnomah County,Multnomah County-Bernalillo County-NM
1910,Multnomah County-Boulder County-CO-1819,"Boulder County, CO",1819,2018,2019,82,4003000,90,4944000,-8,-941000,Multnomah County,Multnomah County-Boulder County-CO
1911,Multnomah County-Miami-Dade County-FL-1819,"Miami-Dade County, FL",1819,2018,2019,91,3627000,71,2642000,20,985000,Multnomah County,Multnomah County-Miami-Dade County-FL
1912,Multnomah County-Santa Cruz County-CA-1819,"Santa Cruz County, CA",1819,2018,2019,96,3524000,55,2628000,41,896000,Multnomah County,Multnomah County-Santa Cruz County-CA
1913,Multnomah County-Dane County-WI-1819,"Dane County, WI",1819,2018,2019,92,4183000,51,2501000,41,1682000,Multnomah County,Multnomah County-Dane County-WI
1914,Multnomah County-Queens County-NY-1819,"Queens County, NY",1819,2018,2019,92,5065000,50,2239000,42,2826000,Multnomah County,Multnomah County-Queens County-NY
1915,Multnomah County-Broward County-FL-1819,"Broward County, FL",1819,2018,2019,91,4582000,47,2913000,44,1669000,Multnomah County,Multnomah County-Broward County-FL
1916,Multnomah County-Jefferson County-CO-1819,"Jefferson County, CO",1819,2018,2019,75,3518000,44,2042000,31,1476000,Multnomah County,Multnomah County-Jefferson County-CO
1917,Multnomah County-Allegheny County-PA-1819,"Allegheny County, PA",1819,2018,2019,70,3509000,77,4314000,-7,-805000,Multnomah County,Multnomah County-Allegheny County-PA
1918,Multnomah County-Davidson County-TN-1819,"Davidson County, TN",1819,2018,2019,73,3424000,66,3239000,7,185000,Multnomah County,Multnomah County-Davidson County-TN
1919,Multnomah County-Coos County-OR-1819,"Coos County, OR",1819,2018,2019,93,2765000,74,2160000,19,605000,Multnomah County,Multnomah County-Coos County-OR
1920,Multnomah County-Fulton County-GA-1819,"Fulton County, GA",1819,2018,2019,75,4070000,82,4094000,-7,-24000,Multnomah County,Multnomah County-Fulton County-GA
1921,Multnomah County-Tillamook County-OR-1819,"Tillamook County, OR",1819,2018,2019,89,3752000,158,8521000,-69,-4769000,Multnomah County,Multnomah County-Tillamook County-OR
1922,Multnomah County-Milwaukee County-WI-1819,"Milwaukee County, WI",1819,2018,2019,69,4262000,34,1897000,35,2365000,Multnomah County,Multnomah County-Milwaukee County-WI
1923,Multnomah County-Arapahoe County-CO-1819,"Arapahoe County, CO",1819,2018,2019,73,2781000,71,2537000,2,244000,Multnomah County,Multnomah County-Arapahoe County-CO
1924,Multnomah County-Josephine County-OR-1819,"Josephine County, OR",1819,2018,2019,64,1848000,67,2423000,-3,-575000,Multnomah County,Multnomah County-Josephine County-OR
1925,Multnomah County-Pinellas County-FL-1819,"Pinellas County, FL",1819,2018,2019,69,2692000,54,2821000,15,-129000,Multnomah County,Multnomah County-Pinellas County-FL
1926,Multnomah County-Kitsap County-WA-1819,"Kitsap County, WA",1819,2018,2019,78,3198000,100,7600000,-22,-4402000,Multnomah County,Multnomah County-Kitsap County-WA
1927,Multnomah County-Orange County-FL-1819,"Orange County, FL",1819,2018,2019,65,2009000,63,5280000,2,-3271000,Multnomah County,Multnomah County-Orange County-FL
1928,Multnomah County-Maui County-HI-1819,"Maui County, HI",1819,2018,2019,75,2641000,62,1682000,13,959000,Multnomah County,Multnomah County-Maui County-HI
1929,Multnomah County-Missoula County-MT-1819,"Missoula County, MT",1819,2018,2019,62,1708000,80,3062000,-18,-1354000,Multnomah County,Multnomah County-Missoula County-MT
1930,Multnomah County-Fresno County-CA-1819,"Fresno County, CA",1819,2018,2019,69,2412000,52,1351000,17,1061000,Multnomah County,Multnomah County-Fresno County-CA
1931,Multnomah County-El Paso County-CO-1819,"El Paso County, CO",1819,2018,2019,64,2100000,55,1832000,9,268000,Multnomah County,Multnomah County-El Paso County-CO
1932,Multnomah County-Douglas County-OR-1819,"Douglas County, OR",1819,2018,2019,71,1553000,80,2407000,-9,-854000,Multnomah County,Multnomah County-Douglas County-OR
1933,Multnomah County-Tarrant County-TX-1819,"Tarrant County, TX",1819,2018,2019,75,1955000,83,2272000,-8,-317000,Multnomah County,Multnomah County-Tarrant County-TX
1934,Multnomah County-Cuyahoga County-OH-1819,"Cuyahoga County, OH",1819,2018,2019,62,2555000,43,1581000,19,974000,Multnomah County,Multnomah County-Cuyahoga County-OH
1935,Multnomah County-Orleans Parish-LA-1819,"Orleans Parish, LA",1819,2018,2019,55,3363000,33,1264000,22,2099000,Multnomah County,Multnomah County-Orleans Parish-LA
1936,Multnomah County-Oakland County-MI-1819,"Oakland County, MI",1819,2018,2019,57,3430000,45,2231000,12,1199000,Multnomah County,Multnomah County-Oakland County-MI
1937,Multnomah County-Mecklenburg County-NC-1819,"Mecklenburg County, NC",1819,2018,2019,62,3709000,74,2839000,-12,870000,Multnomah County,Multnomah County-Mecklenburg County-NC
1938,Multnomah County-Palm Beach County-FL-1819,"Palm Beach County, FL",1819,2018,2019,57,2263000,44,1451000,13,812000,Multnomah County,Multnomah County-Palm Beach County-FL
1939,Multnomah County-Hawaii County-HI-1819,"Hawaii County, HI",1819,2018,2019,71,992000,52,1916000,19,-924000,Multnomah County,Multnomah County-Hawaii County-HI
1940,Multnomah County-Montgomery County-MD-1819,"Montgomery County, MD",1819,2018,2019,68,6606000,35,1292000,33,5314000,Multnomah County,Multnomah County-Montgomery County-MD
1941,Multnomah County-Wake County-NC-1819,"Wake County, NC",1819,2018,2019,57,2534000,50,3462000,7,-928000,Multnomah County,Multnomah County-Wake County-NC
1942,Multnomah County-San Luis Obispo County-CA-1819,"San Luis Obispo County, CA",1819,2018,2019,57,2146000,36,1446000,21,700000,Multnomah County,Multnomah County-San Luis Obispo County-CA
1943,Multnomah County-Larimer County-CO-1819,"Larimer County, CO",1819,2018,2019,54,1951000,59,2325000,-5,-374000,Multnomah County,Multnomah County-Larimer County-CO
1944,Multnomah County-Benton County-WA-1819,"Benton County, WA",1819,2018,2019,65,1962000,70,2380000,-5,-418000,Multnomah County,Multnomah County-Benton County-WA
1945,Multnomah County-Umatilla County-OR-1819,"Umatilla County, OR",1819,2018,2019,56,1475000,63,2259000,-7,-784000,Multnomah County,Multnomah County-Umatilla County-OR
1946,Multnomah County-Wasco County-OR-1819,"Wasco County, OR",1819,2018,2019,68,1515000,129,4830000,-61,-3315000,Multnomah County,Multnomah County-Wasco County-OR
1947,Multnomah County-Chittenden County-VT-1819,"Chittenden County, VT",1819,2018,2019,46,2674000,35,1395000,11,1279000,Multnomah County,Multnomah County-Chittenden County-VT
1948,Multnomah County-Monterey County-CA-1819,"Monterey County, CA",1819,2018,2019,62,2292000,43,1122000,19,1170000,Multnomah County,Multnomah County-Monterey County-CA
1949,Multnomah County-Placer County-CA-1819,"Placer County, CA",1819,2018,2019,57,2022000,32,2741000,25,-719000,Multnomah County,Multnomah County-Placer County-CA
1950,Multnomah County-Humboldt County-CA-1819,"Humboldt County, CA",1819,2018,2019,47,1455000,28,757000,19,698000,Multnomah County,Multnomah County-Humboldt County-CA
1951,Multnomah County-Baltimore city-MD-1819,"Baltimore city, MD",1819,2018,2019,51,4721000,26,1252000,25,3469000,Multnomah County,Multnomah County-Baltimore city-MD
1952,Multnomah County-Wayne County-MI-1819,"Wayne County, MI",1819,2018,2019,52,2529000,34,1442000,18,1087000,Multnomah County,Multnomah County-Wayne County-MI
1953,Multnomah County-Douglas County-NE-1819,"Douglas County, NE",1819,2018,2019,48,1438000,41,1545000,7,-107000,Multnomah County,Multnomah County-Douglas County-NE
1954,Multnomah County-Klickitat County-WA-1819,"Klickitat County, WA",1819,2018,2019,46,1895000,97,8889000,-51,-6994000,Multnomah County,Multnomah County-Klickitat County-WA
1955,Multnomah County-Ramsey County-MN-1819,"Ramsey County, MN",1819,2018,2019,47,1527000,49,1793000,-2,-266000,Multnomah County,Multnomah County-Ramsey County-MN
1956,Multnomah County-Gallatin County-MT-1819,"Gallatin County, MT",1819,2018,2019,39,1210000,40,1817000,-1,-607000,Multnomah County,Multnomah County-Gallatin County-MT
1957,Multnomah County-Washtenaw County-MI-1819,"Washtenaw County, MI",1819,2018,2019,45,2109000,44,1906000,1,203000,Multnomah County,Multnomah County-Washtenaw County-MI
1958,Multnomah County-Durham County-NC-1819,"Durham County, NC",1819,2018,2019,53,2408000,36,3192000,17,-784000,Multnomah County,Multnomah County-Durham County-NC
1959,Multnomah County-Hillsborough County-FL-1819,"Hillsborough County, FL",1819,2018,2019,53,1752000,65,1986000,-12,-234000,Multnomah County,Multnomah County-Hillsborough County-FL
1960,Multnomah County-DeKalb County-GA-1819,"DeKalb County, GA",1819,2018,2019,45,2243000,37,1135000,8,1108000,Multnomah County,Multnomah County-DeKalb County-GA
1961,Multnomah County-Marion County-IN-1819,"Marion County, IN",1819,2018,2019,44,2434000,28,1302000,16,1132000,Multnomah County,Multnomah County-Marion County-IN
1962,Multnomah County-Kent County-MI-1819,"Kent County, MI",1819,2018,2019,37,1246000,41,1488000,-4,-242000,Multnomah County,Multnomah County-Kent County-MI
1963,Multnomah County-Utah County-UT-1819,"Utah County, UT",1819,2018,2019,46,1465000,43,1414000,3,51000,Multnomah County,Multnomah County-Utah County-UT
1964,Multnomah County-Jackson County-MO-1819,"Jackson County, MO",1819,2018,2019,42,1758000,53,1612000,-11,146000,Multnomah County,Multnomah County-Jackson County-MO
1965,Multnomah County-Duval County-FL-1819,"Duval County, FL",1819,2018,2019,34,1684000,46,2136000,-12,-452000,Multnomah County,Multnomah County-Duval County-FL
1966,Multnomah County-Kootenai County-ID-1819,"Kootenai County, ID",1819,2018,2019,36,1281000,62,1316000,-26,-35000,Multnomah County,Multnomah County-Kootenai County-ID
1967,Multnomah County-Klamath County-OR-1819,"Klamath County, OR",1819,2018,2019,43,805000,65,1837000,-22,-1032000,Multnomah County,Multnomah County-Klamath County-OR
1968,Multnomah County-Skamania County-WA-1819,"Skamania County, WA",1819,2018,2019,31,1357000,81,4411000,-50,-3054000,Multnomah County,Multnomah County-Skamania County-WA
1969,Multnomah County-New Haven County-CT-1819,"New Haven County, CT",1819,2018,2019,32,1383000,28,1549000,4,-166000,Multnomah County,Multnomah County-New Haven County-CT
1970,Multnomah County-Walla Walla County-WA-1819,"Walla Walla County, WA",1819,2018,2019,32,953000,36,1119000,-4,-166000,Multnomah County,Multnomah County-Walla Walla County-WA
1971,Multnomah County-Yakima County-WA-1819,"Yakima County, WA",1819,2018,2019,40,926000,48,1185000,-8,-259000,Multnomah County,Multnomah County-Yakima County-WA
1972,Multnomah County-Cumberland County-ME-1819,"Cumberland County, ME",1819,2018,2019,30,1439000,36,1535000,-6,-96000,Multnomah County,Multnomah County-Cumberland County-ME
1973,Multnomah County-Norfolk County-MA-1819,"Norfolk County, MA",1819,2018,2019,38,3526000,26,1251000,12,2275000,Multnomah County,Multnomah County-Norfolk County-MA
1974,Multnomah County-Shelby County-TN-1819,"Shelby County, TN",1819,2018,2019,35,1136000,42,1993000,-7,-857000,Multnomah County,Multnomah County-Shelby County-TN
1975,Multnomah County-Flathead County-MT-1819,"Flathead County, MT",1819,2018,2019,28,537000,51,2080000,-23,-1543000,Multnomah County,Multnomah County-Flathead County-MT
1976,Multnomah County-Lewis County-WA-1819,"Lewis County, WA",1819,2018,2019,35,872000,56,1259000,-21,-387000,Multnomah County,Multnomah County-Lewis County-WA
1977,Multnomah County-Jefferson County-KY-1819,"Jefferson County, KY",1819,2018,2019,30,1594000,46,1573000,-16,21000,Multnomah County,Multnomah County-Jefferson County-KY
1978,Multnomah County-Whitman County-WA-1819,"Whitman County, WA",1819,2018,2019,25,936000,33,1126000,-8,-190000,Multnomah County,Multnomah County-Whitman County-WA
1979,Multnomah County-Santa Fe County-NM-1819,"Santa Fe County, NM",1819,2018,2019,28,1002000,37,1676000,-9,-674000,Multnomah County,Multnomah County-Santa Fe County-NM
1980,Multnomah County-Buncombe County-NC-1819,"Buncombe County, NC",1819,2018,2019,26,712000,45,1808000,-19,-1096000,Multnomah County,Multnomah County-Buncombe County-NC
1981,Multnomah County-Williamson County-TX-1819,"Williamson County, TX",1819,2018,2019,27,1071000,42,1318000,-15,-247000,Multnomah County,Multnomah County-Williamson County-TX
1982,Multnomah County-Island County-WA-1819,"Island County, WA",1819,2018,2019,35,774000,39,980000,-4,-206000,Multnomah County,Multnomah County-Island County-WA
1983,Multnomah County-Union County-OR-1819,"Union County, OR",1819,2018,2019,45,828000,28,556000,17,272000,Multnomah County,Multnomah County-Union County-OR
1985,Polk County-Marion County-OR-1819,"Marion County, OR",1819,2018,2019,2499,64463000,2111,57545000,388,6918000,Polk County,Polk County-Marion County-OR
1986,Polk County-Yamhill County-OR-1819,"Yamhill County, OR",1819,2018,2019,509,12237000,373,8509000,136,3728000,Polk County,Polk County-Yamhill County-OR
1987,Polk County-Washington County-OR-1819,"Washington County, OR",1819,2018,2019,242,7873000,200,5635000,42,2238000,Polk County,Polk County-Washington County-OR
1988,Polk County-Linn County-OR-1819,"Linn County, OR",1819,2018,2019,220,5383000,238,6474000,-18,-1091000,Polk County,Polk County-Linn County-OR
1989,Polk County-Benton County-OR-1819,"Benton County, OR",1819,2018,2019,188,4887000,188,4311000,0,576000,Polk County,Polk County-Benton County-OR
1990,Polk County-Multnomah County-OR-1819,"Multnomah County, OR",1819,2018,2019,150,4198000,132,3513000,18,685000,Polk County,Polk County-Multnomah County-OR
1991,Polk County-Clackamas County-OR-1819,"Clackamas County, OR",1819,2018,2019,144,4167000,140,4179000,4,-12000,Polk County,Polk County-Clackamas County-OR
1992,Polk County-Lane County-OR-1819,"Lane County, OR",1819,2018,2019,132,3593000,88,2748000,44,845000,Polk County,Polk County-Lane County-OR
1993,Polk County-Lincoln County-OR-1819,"Lincoln County, OR",1819,2018,2019,92,2832000,77,1921000,15,911000,Polk County,Polk County-Lincoln County-OR
1994,Polk County-Deschutes County-OR-1819,"Deschutes County, OR",1819,2018,2019,70,2056000,94,2438000,-24,-382000,Polk County,Polk County-Deschutes County-OR
1995,Polk County-Los Angeles County-CA-1819,"Los Angeles County, CA",1819,2018,2019,38,1027000,38,1057000,0,-30000,Polk County,Polk County-Los Angeles County-CA
1996,Polk County-King County-WA-1819,"King County, WA",1819,2018,2019,40,2447000,40,1491000,0,956000,Polk County,Polk County-King County-WA
1997,Polk County-Maricopa County-AZ-1819,"Maricopa County, AZ",1819,2018,2019,57,1240000,52,1832000,5,-592000,Polk County,Polk County-Maricopa County-AZ
1998,Polk County-Clark County-WA-1819,"Clark County, WA",1819,2018,2019,43,1252000,61,1698000,-18,-446000,Polk County,Polk County-Clark County-WA
2001,Tillamook County-Multnomah County-OR-1819,"Multnomah County, OR",1819,2018,2019,158,8521000,89,3752000,69,4769000,Tillamook County,Tillamook County-Multnomah County-OR
2002,Tillamook County-Washington County-OR-1819,"Washington County, OR",1819,2018,2019,168,6499000,101,3652000,67,2847000,Tillamook County,Tillamook County-Washington County-OR
2003,Tillamook County-Clackamas County-OR-1819,"Clackamas County, OR",1819,2018,2019,96,3558000,49,1344000,47,2214000,Tillamook County,Tillamook County-Clackamas County-OR
2004,Tillamook County-Lincoln County-OR-1819,"Lincoln County, OR",1819,2018,2019,47,1588000,35,964000,12,624000,Tillamook County,Tillamook County-Lincoln County-OR
2005,Tillamook County-Clatsop County-OR-1819,"Clatsop County, OR",1819,2018,2019,55,1075000,50,1418000,5,-343000,Tillamook County,Tillamook County-Clatsop County-OR
2007,Umatilla County-Walla Walla County-WA-1819,"Walla Walla County, WA",1819,2018,2019,311,6754000,280,8012000,31,-1258000,Umatilla County,Umatilla County-Walla Walla County-WA
2008,Umatilla County-Morrow County-OR-1819,"Morrow County, OR",1819,2018,2019,254,6123000,305,6184000,-51,-61000,Umatilla County,Umatilla County-Morrow County-OR
2009,Umatilla County-Benton County-WA-1819,"Benton County, WA",1819,2018,2019,176,4848000,264,8378000,-88,-3530000,Umatilla County,Umatilla County-Benton County-WA
2010,Umatilla County-Union County-OR-1819,"Union County, OR",1819,2018,2019,111,2603000,97,2420000,14,183000,Umatilla County,Umatilla County-Union County-OR
2011,Umatilla County-Multnomah County-OR-1819,"Multnomah County, OR",1819,2018,2019,63,2259000,56,1475000,7,784000,Umatilla County,Umatilla County-Multnomah County-OR
2012,Umatilla County-Washington County-OR-1819,"Washington County, OR",1819,2018,2019,60,1833000,43,1396000,17,437000,Umatilla County,Umatilla County-Washington County-OR
2013,Umatilla County-Franklin County-WA-1819,"Franklin County, WA",1819,2018,2019,75,1191000,114,2432000,-39,-1241000,Umatilla County,Umatilla County-Franklin County-WA
2014,Umatilla County-Clackamas County-OR-1819,"Clackamas County, OR",1819,2018,2019,46,1788000,45,1325000,1,463000,Umatilla County,Umatilla County-Clackamas County-OR
2015,Umatilla County-Spokane County-WA-1819,"Spokane County, WA",1819,2018,2019,52,1174000,51,832000,1,342000,Umatilla County,Umatilla County-Spokane County-WA
2016,Umatilla County-Deschutes County-OR-1819,"Deschutes County, OR",1819,2018,2019,38,992000,41,1650000,-3,-658000,Umatilla County,Umatilla County-Deschutes County-OR
2017,Umatilla County-Ada County-ID-1819,"Ada County, ID",1819,2018,2019,37,914000,49,1526000,-12,-612000,Umatilla County,Umatilla County-Ada County-ID
2018,Umatilla County-Lane County-OR-1819,"Lane County, OR",1819,2018,2019,30,568000,47,873000,-17,-305000,Umatilla County,Umatilla County-Lane County-OR
2020,Union County-Umatilla County-OR-1819,"Umatilla County, OR",1819,2018,2019,97,2420000,111,2603000,-14,-183000,Union County,Union County-Umatilla County-OR
2021,Union County-Baker County-OR-1819,"Baker County, OR",1819,2018,2019,71,1476000,97,2149000,-26,-673000,Union County,Union County-Baker County-OR
2022,Union County-Ada County-ID-1819,"Ada County, ID",1819,2018,2019,28,708000,61,2390000,-33,-1682000,Union County,Union County-Ada County-ID
2023,Union County-Multnomah County-OR-1819,"Multnomah County, OR",1819,2018,2019,28,556000,45,828000,-17,-272000,Union County,Union County-Multnomah County-OR
2026,Wasco County-Hood River County-OR-1819,"Hood River County, OR",1819,2018,2019,286,6278000,141,3690000,145,2588000,Wasco County,Wasco County-Hood River County-OR
2027,Wasco County-Multnomah County-OR-1819,"Multnomah County, OR",1819,2018,2019,129,4830000,68,1515000,61,3315000,Wasco County,Wasco County-Multnomah County-OR
2028,Wasco County-Klickitat County-WA-1819,"Klickitat County, WA",1819,2018,2019,128,2875000,162,3443000,-34,-568000,Wasco County,Wasco County-Klickitat County-WA
2029,Wasco County-Clackamas County-OR-1819,"Clackamas County, OR",1819,2018,2019,82,2514000,48,1918000,34,596000,Wasco County,Wasco County-Clackamas County-OR
2030,Wasco County-Clark County-WA-1819,"Clark County, WA",1819,2018,2019,39,1375000,54,1880000,-15,-505000,Wasco County,Wasco County-Clark County-WA
2031,Wasco County-Washington County-OR-1819,"Washington County, OR",1819,2018,2019,29,1066000,49,1256000,-20,-190000,Wasco County,Wasco County-Washington County-OR
2032,Wasco County-Deschutes County-OR-1819,"Deschutes County, OR",1819,2018,2019,43,1228000,34,774000,9,454000,Wasco County,Wasco County-Deschutes County-OR
2034,Washington County-Multnomah County-OR-1819,"Multnomah County, OR",1819,2018,2019,7018,342959000,6320,315447000,698,27512000,Washington County,Washington County-Multnomah County-OR
2035,Washington County-Clackamas County-OR-1819,"Clackamas County, OR",1819,2018,2019,3205,161719000,3797,168063000,-592,-6344000,Washington County,Washington County-Clackamas County-OR
2036,Washington County-Clark County-WA-1819,"Clark County, WA",1819,2018,2019,1320,49768000,1881,111026000,-561,-61258000,Washington County,Washington County-Clark County-WA
2037,Washington County-Yamhill County-OR-1819,"Yamhill County, OR",1819,2018,2019,942,30765000,1529,50093000,-587,-19328000,Washington County,Washington County-Yamhill County-OR
2038,Washington County-Marion County-OR-1819,"Marion County, OR",1819,2018,2019,925,27670000,1175,34227000,-250,-6557000,Washington County,Washington County-Marion County-OR
2039,Washington County-Los Angeles County-CA-1819,"Los Angeles County, CA",1819,2018,2019,750,28362000,424,15260000,326,13102000,Washington County,Washington County-Los Angeles County-CA
2040,Washington County-King County-WA-1819,"King County, WA",1819,2018,2019,629,35525000,834,55172000,-205,-19647000,Washington County,Washington County-King County-WA
2041,Washington County-Maricopa County-AZ-1819,"Maricopa County, AZ",1819,2018,2019,587,23930000,882,49834000,-295,-25904000,Washington County,Washington County-Maricopa County-AZ
2042,Washington County-Lane County-OR-1819,"Lane County, OR",1819,2018,2019,476,15008000,391,12665000,85,2343000,Washington County,Washington County-Lane County-OR
2043,Washington County-Santa Clara County-CA-1819,"Santa Clara County, CA",1819,2018,2019,573,55167000,476,42192000,97,12975000,Washington County,Washington County-Santa Clara County-CA
2044,Washington County-Benton County-OR-1819,"Benton County, OR",1819,2018,2019,314,9747000,171,5068000,143,4679000,Washington County,Washington County-Benton County-OR
2045,Washington County-Columbia County-OR-1819,"Columbia County, OR",1819,2018,2019,415,11246000,639,22470000,-224,-11224000,Washington County,Washington County-Columbia County-OR
2046,Washington County-Orange County-CA-1819,"Orange County, CA",1819,2018,2019,365,16230000,184,9552000,181,6678000,Washington County,Washington County-Orange County-CA
2047,Washington County-San Diego County-CA-1819,"San Diego County, CA",1819,2018,2019,358,13007000,343,14553000,15,-1546000,Washington County,Washington County-San Diego County-CA
2048,Washington County-Deschutes County-OR-1819,"Deschutes County, OR",1819,2018,2019,260,12011000,565,30209000,-305,-18198000,Washington County,Washington County-Deschutes County-OR
2049,Washington County-Alameda County-CA-1819,"Alameda County, CA",1819,2018,2019,281,14881000,147,9215000,134,5666000,Washington County,Washington County-Alameda County-CA
2050,Washington County-Honolulu County-HI-1819,"Honolulu County, HI",1819,2018,2019,252,7238000,122,4851000,130,2387000,Washington County,Washington County-Honolulu County-HI
2051,Washington County-Jackson County-OR-1819,"Jackson County, OR",1819,2018,2019,210,6033000,201,5731000,9,302000,Washington County,Washington County-Jackson County-OR
2052,Washington County-Clark County-NV-1819,"Clark County, NV",1819,2018,2019,265,7412000,294,11471000,-29,-4059000,Washington County,Washington County-Clark County-NV
2053,Washington County-Polk County-OR-1819,"Polk County, OR",1819,2018,2019,200,5635000,242,7873000,-42,-2238000,Washington County,Washington County-Polk County-OR
2054,Washington County-Riverside County-CA-1819,"Riverside County, CA",1819,2018,2019,213,7350000,133,7240000,80,110000,Washington County,Washington County-Riverside County-CA
2055,Washington County-Cook County-IL-1819,"Cook County, IL",1819,2018,2019,163,8071000,88,4305000,75,3766000,Washington County,Washington County-Cook County-IL
2056,Washington County-Pierce County-WA-1819,"Pierce County, WA",1819,2018,2019,177,6756000,199,8668000,-22,-1912000,Washington County,Washington County-Pierce County-WA
2057,Washington County-Sacramento County-CA-1819,"Sacramento County, CA",1819,2018,2019,168,8587000,151,5123000,17,3464000,Washington County,Washington County-Sacramento County-CA
2058,Washington County-Linn County-OR-1819,"Linn County, OR",1819,2018,2019,151,3477000,186,5688000,-35,-2211000,Washington County,Washington County-Linn County-OR
2059,Washington County-Clatsop County-OR-1819,"Clatsop County, OR",1819,2018,2019,151,5331000,167,5727000,-16,-396000,Washington County,Washington County-Clatsop County-OR
2060,Washington County-Snohomish County-WA-1819,"Snohomish County, WA",1819,2018,2019,181,8041000,239,10534000,-58,-2493000,Washington County,Washington County-Snohomish County-WA
2061,Washington County-Harris County-TX-1819,"Harris County, TX",1819,2018,2019,160,5608000,117,4462000,43,1146000,Washington County,Washington County-Harris County-TX
2062,Washington County-Ada County-ID-1819,"Ada County, ID",1819,2018,2019,158,6510000,237,12871000,-79,-6361000,Washington County,Washington County-Ada County-ID
2063,Washington County-Travis County-TX-1819,"Travis County, TX",1819,2018,2019,148,9103000,186,13906000,-38,-4803000,Washington County,Washington County-Travis County-TX
2064,Washington County-Spokane County-WA-1819,"Spokane County, WA",1819,2018,2019,138,4826000,159,6439000,-21,-1613000,Washington County,Washington County-Spokane County-WA
2065,Washington County-San Bernardino County-CA-1819,"San Bernardino County, CA",1819,2018,2019,131,2984000,81,2636000,50,348000,Washington County,Washington County-San Bernardino County-CA
2066,Washington County-San Mateo County-CA-1819,"San Mateo County, CA",1819,2018,2019,160,9089000,76,5439000,84,3650000,Washington County,Washington County-San Mateo County-CA
2067,Washington County-Salt Lake County-UT-1819,"Salt Lake County, UT",1819,2018,2019,143,5315000,100,3705000,43,1610000,Washington County,Washington County-Salt Lake County-UT
2068,Washington County-Contra Costa County-CA-1819,"Contra Costa County, CA",1819,2018,2019,135,9026000,53,2633000,82,6393000,Washington County,Washington County-Contra Costa County-CA
2069,Washington County-San Francisco County-CA-1819,"San Francisco County, CA",1819,2018,2019,99,7358000,59,4200000,40,3158000,Washington County,Washington County-San Francisco County-CA
2070,Washington County-Tillamook County-OR-1819,"Tillamook County, OR",1819,2018,2019,101,3652000,168,6499000,-67,-2847000,Washington County,Washington County-Tillamook County-OR
2071,Washington County-Lincoln County-OR-1819,"Lincoln County, OR",1819,2018,2019,96,3070000,121,5724000,-25,-2654000,Washington County,Washington County-Lincoln County-OR
2072,Washington County-Dallas County-TX-1819,"Dallas County, TX",1819,2018,2019,89,3614000,91,5100000,-2,-1486000,Washington County,Washington County-Dallas County-TX
2073,Washington County-Thurston County-WA-1819,"Thurston County, WA",1819,2018,2019,73,2268000,136,4386000,-63,-2118000,Washington County,Washington County-Thurston County-WA
2074,Washington County-Washoe County-NV-1819,"Washoe County, NV",1819,2018,2019,77,3421000,75,2403000,2,1018000,Washington County,Washington County-Washoe County-NV
2075,Washington County-Douglas County-OR-1819,"Douglas County, OR",1819,2018,2019,86,2119000,129,3613000,-43,-1494000,Washington County,Washington County-Douglas County-OR
2076,Washington County-Hennepin County-MN-1819,"Hennepin County, MN",1819,2018,2019,100,4822000,77,6059000,23,-1237000,Washington County,Washington County-Hennepin County-MN
2077,Washington County-Pima County-AZ-1819,"Pima County, AZ",1819,2018,2019,80,2338000,122,4490000,-42,-2152000,Washington County,Washington County-Pima County-AZ
2078,Washington County-Ventura County-CA-1819,"Ventura County, CA",1819,2018,2019,105,3447000,37,1375000,68,2072000,Washington County,Washington County-Ventura County-CA
2079,Washington County-Middlesex County-MA-1819,"Middlesex County, MA",1819,2018,2019,85,6153000,62,4449000,23,1704000,Washington County,Washington County-Middlesex County-MA
2080,Washington County-Cowlitz County-WA-1819,"Cowlitz County, WA",1819,2018,2019,109,3293000,158,5142000,-49,-1849000,Washington County,Washington County-Cowlitz County-WA
2081,Washington County-Anchorage Municipality-AK-1819,"Anchorage Municipality, AK",1819,2018,2019,80,3089000,42,1476000,38,1613000,Washington County,Washington County-Anchorage Municipality-AK
2082,Washington County-Franklin County-OH-1819,"Franklin County, OH",1819,2018,2019,60,3329000,45,878000,15,2451000,Washington County,Washington County-Franklin County-OH
2083,Washington County-Tarrant County-TX-1819,"Tarrant County, TX",1819,2018,2019,73,2560000,63,2090000,10,470000,Washington County,Washington County-Tarrant County-TX
2084,Washington County-Utah County-UT-1819,"Utah County, UT",1819,2018,2019,99,2568000,142,5081000,-43,-2513000,Washington County,Washington County-Utah County-UT
2085,Washington County-Denver County-CO-1819,"Denver County, CO",1819,2018,2019,57,2160000,54,3166000,3,-1006000,Washington County,Washington County-Denver County-CO
2086,Washington County-New York County-NY-1819,"New York County, NY",1819,2018,2019,61,4869000,57,3361000,4,1508000,Washington County,Washington County-New York County-NY
2087,Washington County-El Paso County-CO-1819,"El Paso County, CO",1819,2018,2019,68,2234000,45,1548000,23,686000,Washington County,Washington County-El Paso County-CO
2088,Washington County-Wake County-NC-1819,"Wake County, NC",1819,2018,2019,59,2381000,48,2432000,11,-51000,Washington County,Washington County-Wake County-NC
2089,Washington County-Josephine County-OR-1819,"Josephine County, OR",1819,2018,2019,53,1626000,40,1197000,13,429000,Washington County,Washington County-Josephine County-OR
2090,Washington County-Collin County-TX-1819,"Collin County, TX",1819,2018,2019,69,4106000,134,5245000,-65,-1139000,Washington County,Washington County-Collin County-TX
2091,Washington County-Bernalillo County-NM-1819,"Bernalillo County, NM",1819,2018,2019,52,1643000,73,4131000,-21,-2488000,Washington County,Washington County-Bernalillo County-NM
2092,Washington County-Klamath County-OR-1819,"Klamath County, OR",1819,2018,2019,62,1767000,70,1369000,-8,398000,Washington County,Washington County-Klamath County-OR
2093,Washington County-Whatcom County-WA-1819,"Whatcom County, WA",1819,2018,2019,55,1674000,63,2177000,-8,-503000,Washington County,Washington County-Whatcom County-WA
2094,Washington County-Yakima County-WA-1819,"Yakima County, WA",1819,2018,2019,76,1537000,27,1119000,49,418000,Washington County,Washington County-Yakima County-WA
2095,Washington County-Benton County-WA-1819,"Benton County, WA",1819,2018,2019,67,1981000,62,2348000,5,-367000,Washington County,Washington County-Benton County-WA
2096,Washington County-Bexar County-TX-1819,"Bexar County, TX",1819,2018,2019,63,1846000,76,2219000,-13,-373000,Washington County,Washington County-Bexar County-TX
2097,Washington County-Kitsap County-WA-1819,"Kitsap County, WA",1819,2018,2019,60,1772000,55,1697000,5,75000,Washington County,Washington County-Kitsap County-WA
2098,Washington County-Jefferson County-CO-1819,"Jefferson County, CO",1819,2018,2019,52,2119000,53,2665000,-1,-546000,Washington County,Washington County-Jefferson County-CO
2099,Washington County-Kings County-NY-1819,"Kings County, NY",1819,2018,2019,45,2826000,31,1111000,14,1715000,Washington County,Washington County-Kings County-NY
2100,Washington County-Fresno County-CA-1819,"Fresno County, CA",1819,2018,2019,51,1630000,58,1640000,-7,-10000,Washington County,Washington County-Fresno County-CA
2101,Washington County-Umatilla County-OR-1819,"Umatilla County, OR",1819,2018,2019,43,1396000,60,1833000,-17,-437000,Washington County,Washington County-Umatilla County-OR
2102,Washington County-Solano County-CA-1819,"Solano County, CA",1819,2018,2019,50,1647000,41,905000,9,742000,Washington County,Washington County-Solano County-CA
2103,Washington County-Wasco County-OR-1819,"Wasco County, OR",1819,2018,2019,49,1256000,29,1066000,20,190000,Washington County,Washington County-Wasco County-OR
2104,Washington County-Coos County-OR-1819,"Coos County, OR",1819,2018,2019,41,1376000,45,1272000,-4,104000,Washington County,Washington County-Coos County-OR
2105,Washington County-Arapahoe County-CO-1819,"Arapahoe County, CO",1819,2018,2019,49,1955000,69,3012000,-20,-1057000,Washington County,Washington County-Arapahoe County-CO
2106,Washington County-Hawaii County-HI-1819,"Hawaii County, HI",1819,2018,2019,41,1903000,44,1225000,-3,678000,Washington County,Washington County-Hawaii County-HI
2107,Washington County-Allegheny County-PA-1819,"Allegheny County, PA",1819,2018,2019,44,1936000,46,2362000,-2,-426000,Washington County,Washington County-Allegheny County-PA
2108,Washington County-Hillsborough County-FL-1819,"Hillsborough County, FL",1819,2018,2019,44,1448000,44,1415000,0,33000,Washington County,Washington County-Hillsborough County-FL
2109,Washington County-Orange County-FL-1819,"Orange County, FL",1819,2018,2019,37,1374000,43,1524000,-6,-150000,Washington County,Washington County-Orange County-FL
2110,Washington County-Boulder County-CO-1819,"Boulder County, CO",1819,2018,2019,30,1287000,36,2136000,-6,-849000,Washington County,Washington County-Boulder County-CO
2111,Washington County-Mecklenburg County-NC-1819,"Mecklenburg County, NC",1819,2018,2019,34,1757000,51,2197000,-17,-440000,Washington County,Washington County-Mecklenburg County-NC
2112,Washington County-Canyon County-ID-1819,"Canyon County, ID",1819,2018,2019,31,592000,62,1563000,-31,-971000,Washington County,Washington County-Canyon County-ID
2113,Washington County-Hood River County-OR-1819,"Hood River County, OR",1819,2018,2019,34,1034000,52,2266000,-18,-1232000,Washington County,Washington County-Hood River County-OR
2114,Washington County-Fairfax County-VA-1819,"Fairfax County, VA",1819,2018,2019,43,2087000,68,3275000,-25,-1188000,Washington County,Washington County-Fairfax County-VA
2115,Washington County-Kootenai County-ID-1819,"Kootenai County, ID",1819,2018,2019,36,970000,59,2918000,-23,-1948000,Washington County,Washington County-Kootenai County-ID
2118,Yamhill County-Washington County-OR-1819,"Washington County, OR",1819,2018,2019,1529,50093000,942,30765000,587,19328000,Yamhill County,Yamhill County-Washington County-OR
2119,Yamhill County-Clackamas County-OR-1819,"Clackamas County, OR",1819,2018,2019,395,15122000,340,11186000,55,3936000,Yamhill County,Yamhill County-Clackamas County-OR
2120,Yamhill County-Marion County-OR-1819,"Marion County, OR",1819,2018,2019,388,10015000,548,13814000,-160,-3799000,Yamhill County,Yamhill County-Marion County-OR
2121,Yamhill County-Multnomah County-OR-1819,"Multnomah County, OR",1819,2018,2019,295,13284000,283,10650000,12,2634000,Yamhill County,Yamhill County-Multnomah County-OR
2122,Yamhill County-Polk County-OR-1819,"Polk County, OR",1819,2018,2019,373,8509000,509,12237000,-136,-3728000,Yamhill County,Yamhill County-Polk County-OR
2123,Yamhill County-Lane County-OR-1819,"Lane County, OR",1819,2018,2019,78,2392000,84,2783000,-6,-391000,Yamhill County,Yamhill County-Lane County-OR
2124,Yamhill County-King County-WA-1819,"King County, WA",1819,2018,2019,69,5806000,42,2312000,27,3494000,Yamhill County,Yamhill County-King County-WA
2125,Yamhill County-Los Angeles County-CA-1819,"Los Angeles County, CA",1819,2018,2019,53,2412000,48,986000,5,1426000,Yamhill County,Yamhill County-Los Angeles County-CA
2126,Yamhill County-Clark County-WA-1819,"Clark County, WA",1819,2018,2019,80,2592000,87,3124000,-7,-532000,Yamhill County,Yamhill County-Clark County-WA
2127,Yamhill County-Deschutes County-OR-1819,"Deschutes County, OR",1819,2018,2019,64,1823000,119,3235000,-55,-1412000,Yamhill County,Yamhill County-Deschutes County-OR
2128,Yamhill County-Lincoln County-OR-1819,"Lincoln County, OR",1819,2018,2019,51,1619000,77,2300000,-26,-681000,Yamhill County,Yamhill County-Lincoln County-OR
2129,Yamhill County-Linn County-OR-1819,"Linn County, OR",1819,2018,2019,49,1098000,95,2390000,-46,-1292000,Yamhill County,Yamhill County-Linn County-OR
2130,Yamhill County-Benton County-OR-1819,"Benton County, OR",1819,2018,2019,44,1815000,42,1014000,2,801000,Yamhill County,Yamhill County-Benton County-OR
2131,Yamhill County-Columbia County-OR-1819,"Columbia County, OR",1819,2018,2019,52,1879000,43,1120000,9,759000,Yamhill County,Yamhill County-Columbia County-OR
2133,Baker County-Union County-OR-1920,"Union County, OR",1920,2019,2020,81,1953000,75,1620000,6,333000,Baker County,Baker County-Union County-OR
2134,Baker County-Ada County-ID-1920,"Ada County, ID",1920,2019,2020,32,1179000,42,1468000,-10,-289000,Baker County,Baker County-Ada County-ID
2136,Benton County-Linn County-OR-1920,"Linn County, OR",1920,2019,2020,1270,35011000,1175,35758000,95,-747000,Benton County,Benton County-Linn County-OR
2137,Benton County-Lane County-OR-1920,"Lane County, OR",1920,2019,2020,398,7355000,348,10106000,50,-2751000,Benton County,Benton County-Lane County-OR
2138,Benton County-Multnomah County-OR-1920,"Multnomah County, OR",1920,2019,2020,267,10562000,369,12100000,-102,-1538000,Benton County,Benton County-Multnomah County-OR
2139,Benton County-Marion County-OR-1920,"Marion County, OR",1920,2019,2020,275,9332000,302,11449000,-27,-2117000,Benton County,Benton County-Marion County-OR
2140,Benton County-Washington County-OR-1920,"Washington County, OR",1920,2019,2020,160,6304000,305,10082000,-145,-3778000,Benton County,Benton County-Washington County-OR
2141,Benton County-Polk County-OR-1920,"Polk County, OR",1920,2019,2020,179,4537000,191,5900000,-12,-1363000,Benton County,Benton County-Polk County-OR
2142,Benton County-Clackamas County-OR-1920,"Clackamas County, OR",1920,2019,2020,138,4516000,140,5923000,-2,-1407000,Benton County,Benton County-Clackamas County-OR
2143,Benton County-Lincoln County-OR-1920,"Lincoln County, OR",1920,2019,2020,131,4081000,91,3140000,40,941000,Benton County,Benton County-Lincoln County-OR
2144,Benton County-Deschutes County-OR-1920,"Deschutes County, OR",1920,2019,2020,97,2664000,182,8150000,-85,-5486000,Benton County,Benton County-Deschutes County-OR
2145,Benton County-Los Angeles County-CA-1920,"Los Angeles County, CA",1920,2019,2020,72,3723000,44,1279000,28,2444000,Benton County,Benton County-Los Angeles County-CA
2146,Benton County-Jackson County-OR-1920,"Jackson County, OR",1920,2019,2020,105,2703000,49,1763000,56,940000,Benton County,Benton County-Jackson County-OR
2147,Benton County-King County-WA-1920,"King County, WA",1920,2019,2020,87,5206000,112,4247000,-25,959000,Benton County,Benton County-King County-WA
2148,Benton County-Maricopa County-AZ-1920,"Maricopa County, AZ",1920,2019,2020,52,2245000,60,3836000,-8,-1591000,Benton County,Benton County-Maricopa County-AZ
2149,Benton County-San Diego County-CA-1920,"San Diego County, CA",1920,2019,2020,52,2233000,48,2350000,4,-117000,Benton County,Benton County-San Diego County-CA
2150,Benton County-Santa Clara County-CA-1920,"Santa Clara County, CA",1920,2019,2020,63,4011000,22,1673000,41,2338000,Benton County,Benton County-Santa Clara County-CA
2151,Benton County-Douglas County-OR-1920,"Douglas County, OR",1920,2019,2020,46,1386000,61,1337000,-15,49000,Benton County,Benton County-Douglas County-OR
2152,Benton County-Yamhill County-OR-1920,"Yamhill County, OR",1920,2019,2020,38,851000,46,1475000,-8,-624000,Benton County,Benton County-Yamhill County-OR
2153,Benton County-Alameda County-CA-1920,"Alameda County, CA",1920,2019,2020,35,2627000,34,1378000,1,1249000,Benton County,Benton County-Alameda County-CA
2154,Benton County-Clark County-WA-1920,"Clark County, WA",1920,2019,2020,33,1814000,63,2106000,-30,-292000,Benton County,Benton County-Clark County-WA
2156,Clackamas County-Multnomah County-OR-1920,"Multnomah County, OR",1920,2019,2020,10731,462807000,6233,231652000,4498,231155000,Clackamas County,Clackamas County-Multnomah County-OR
2157,Clackamas County-Washington County-OR-1920,"Washington County, OR",1920,2019,2020,4181,230095000,3385,142290000,796,87805000,Clackamas County,Clackamas County-Washington County-OR
2158,Clackamas County-Marion County-OR-1920,"Marion County, OR",1920,2019,2020,1564,48417000,1807,54967000,-243,-6550000,Clackamas County,Clackamas County-Marion County-OR
2159,Clackamas County-Clark County-WA-1920,"Clark County, WA",1920,2019,2020,1010,40107000,1719,79134000,-709,-39027000,Clackamas County,Clackamas County-Clark County-WA
2160,Clackamas County-Los Angeles County-CA-1920,"Los Angeles County, CA",1920,2019,2020,438,23900000,162,6096000,276,17804000,Clackamas County,Clackamas County-Los Angeles County-CA
2161,Clackamas County-Lane County-OR-1920,"Lane County, OR",1920,2019,2020,351,9611000,300,8766000,51,845000,Clackamas County,Clackamas County-Lane County-OR
2162,Clackamas County-Yamhill County-OR-1920,"Yamhill County, OR",1920,2019,2020,343,11920000,473,17619000,-130,-5699000,Clackamas County,Clackamas County-Yamhill County-OR
2163,Clackamas County-King County-WA-1920,"King County, WA",1920,2019,2020,310,22346000,265,14912000,45,7434000,Clackamas County,Clackamas County-King County-WA
2164,Clackamas County-Deschutes County-OR-1920,"Deschutes County, OR",1920,2019,2020,278,11629000,604,29842000,-326,-18213000,Clackamas County,Clackamas County-Deschutes County-OR
2165,Clackamas County-Maricopa County-AZ-1920,"Maricopa County, AZ",1920,2019,2020,245,9127000,581,36931000,-336,-27804000,Clackamas County,Clackamas County-Maricopa County-AZ
2166,Clackamas County-San Diego County-CA-1920,"San Diego County, CA",1920,2019,2020,228,22811000,166,8167000,62,14644000,Clackamas County,Clackamas County-San Diego County-CA
2167,Clackamas County-Santa Clara County-CA-1920,"Santa Clara County, CA",1920,2019,2020,292,30597000,38,3609000,254,26988000,Clackamas County,Clackamas County-Santa Clara County-CA
2168,Clackamas County-Orange County-CA-1920,"Orange County, CA",1920,2019,2020,201,9056000,118,6558000,83,2498000,Clackamas County,Clackamas County-Orange County-CA
2169,Clackamas County-Polk County-OR-1920,"Polk County, OR",1920,2019,2020,185,6261000,207,6385000,-22,-124000,Clackamas County,Clackamas County-Polk County-OR
2170,Clackamas County-Benton County-OR-1920,"Benton County, OR",1920,2019,2020,140,5923000,138,4516000,2,1407000,Clackamas County,Clackamas County-Benton County-OR
2171,Clackamas County-Jackson County-OR-1920,"Jackson County, OR",1920,2019,2020,143,5075000,195,6393000,-52,-1318000,Clackamas County,Clackamas County-Jackson County-OR
2172,Clackamas County-Clark County-NV-1920,"Clark County, NV",1920,2019,2020,162,6585000,150,10024000,12,-3439000,Clackamas County,Clackamas County-Clark County-NV
2173,Clackamas County-Linn County-OR-1920,"Linn County, OR",1920,2019,2020,113,3851000,141,5458000,-28,-1607000,Clackamas County,Clackamas County-Linn County-OR
2174,Clackamas County-Columbia County-OR-1920,"Columbia County, OR",1920,2019,2020,143,5910000,248,6509000,-105,-599000,Clackamas County,Clackamas County-Columbia County-OR
2175,Clackamas County-Pierce County-WA-1920,"Pierce County, WA",1920,2019,2020,143,4922000,131,4567000,12,355000,Clackamas County,Clackamas County-Pierce County-WA
2176,Clackamas County-Snohomish County-WA-1920,"Snohomish County, WA",1920,2019,2020,119,5411000,103,4919000,16,492000,Clackamas County,Clackamas County-Snohomish County-WA
2177,Clackamas County-Riverside County-CA-1920,"Riverside County, CA",1920,2019,2020,114,6574000,114,8279000,0,-1705000,Clackamas County,Clackamas County-Riverside County-CA
2178,Clackamas County-Contra Costa County-CA-1920,"Contra Costa County, CA",1920,2019,2020,123,7567000,45,3523000,78,4044000,Clackamas County,Clackamas County-Contra Costa County-CA
2179,Clackamas County-Honolulu County-HI-1920,"Honolulu County, HI",1920,2019,2020,83,3052000,67,2546000,16,506000,Clackamas County,Clackamas County-Honolulu County-HI
2180,Clackamas County-Sacramento County-CA-1920,"Sacramento County, CA",1920,2019,2020,92,3848000,45,1751000,47,2097000,Clackamas County,Clackamas County-Sacramento County-CA
2181,Clackamas County-Salt Lake County-UT-1920,"Salt Lake County, UT",1920,2019,2020,93,3413000,74,4528000,19,-1115000,Clackamas County,Clackamas County-Salt Lake County-UT
2182,Clackamas County-San Bernardino County-CA-1920,"San Bernardino County, CA",1920,2019,2020,88,2138000,38,901000,50,1237000,Clackamas County,Clackamas County-San Bernardino County-CA
2183,Clackamas County-Lincoln County-OR-1920,"Lincoln County, OR",1920,2019,2020,67,2748000,156,6188000,-89,-3440000,Clackamas County,Clackamas County-Lincoln County-OR
2184,Clackamas County-Wasco County-OR-1920,"Wasco County, OR",1920,2019,2020,74,1740000,70,3495000,4,-1755000,Clackamas County,Clackamas County-Wasco County-OR
2185,Clackamas County-Spokane County-WA-1920,"Spokane County, WA",1920,2019,2020,70,2820000,129,4355000,-59,-1535000,Clackamas County,Clackamas County-Spokane County-WA
2186,Clackamas County-Tillamook County-OR-1920,"Tillamook County, OR",1920,2019,2020,64,2021000,111,5384000,-47,-3363000,Clackamas County,Clackamas County-Tillamook County-OR
2187,Clackamas County-Thurston County-WA-1920,"Thurston County, WA",1920,2019,2020,78,2166000,69,2609000,9,-443000,Clackamas County,Clackamas County-Thurston County-WA
2188,Clackamas County-Ada County-ID-1920,"Ada County, ID",1920,2019,2020,72,3122000,204,9020000,-132,-5898000,Clackamas County,Clackamas County-Ada County-ID
2189,Clackamas County-Clatsop County-OR-1920,"Clatsop County, OR",1920,2019,2020,45,1476000,136,6613000,-91,-5137000,Clackamas County,Clackamas County-Clatsop County-OR
2190,Clackamas County-Cowlitz County-WA-1920,"Cowlitz County, WA",1920,2019,2020,65,1835000,161,9170000,-96,-7335000,Clackamas County,Clackamas County-Cowlitz County-WA
2191,Clackamas County-Jefferson County-OR-1920,"Jefferson County, OR",1920,2019,2020,50,1031000,110,3877000,-60,-2846000,Clackamas County,Clackamas County-Jefferson County-OR
2192,Clackamas County-Klamath County-OR-1920,"Klamath County, OR",1920,2019,2020,55,1421000,58,1731000,-3,-310000,Clackamas County,Clackamas County-Klamath County-OR
2193,Clackamas County-Washoe County-NV-1920,"Washoe County, NV",1920,2019,2020,37,1312000,70,3849000,-33,-2537000,Clackamas County,Clackamas County-Washoe County-NV
2194,Clackamas County-Pima County-AZ-1920,"Pima County, AZ",1920,2019,2020,47,1061000,93,7135000,-46,-6074000,Clackamas County,Clackamas County-Pima County-AZ
2195,Clackamas County-Cook County-IL-1920,"Cook County, IL",1920,2019,2020,48,2817000,31,1109000,17,1708000,Clackamas County,Clackamas County-Cook County-IL
2196,Clackamas County-Josephine County-OR-1920,"Josephine County, OR",1920,2019,2020,37,914000,60,2041000,-23,-1127000,Clackamas County,Clackamas County-Josephine County-OR
2197,Clackamas County-Umatilla County-OR-1920,"Umatilla County, OR",1920,2019,2020,50,1249000,67,1372000,-17,-123000,Clackamas County,Clackamas County-Umatilla County-OR
2198,Clackamas County-Harris County-TX-1920,"Harris County, TX",1920,2019,2020,61,2538000,57,1623000,4,915000,Clackamas County,Clackamas County-Harris County-TX
2199,Clackamas County-Douglas County-OR-1920,"Douglas County, OR",1920,2019,2020,51,1286000,105,3011000,-54,-1725000,Clackamas County,Clackamas County-Douglas County-OR
2200,Clackamas County-Travis County-TX-1920,"Travis County, TX",1920,2019,2020,43,3233000,51,3659000,-8,-426000,Clackamas County,Clackamas County-Travis County-TX
2201,Clackamas County-Utah County-UT-1920,"Utah County, UT",1920,2019,2020,70,942000,76,2985000,-6,-2043000,Clackamas County,Clackamas County-Utah County-UT
2202,Clackamas County-Bexar County-TX-1920,"Bexar County, TX",1920,2019,2020,47,2156000,42,1270000,5,886000,Clackamas County,Clackamas County-Bexar County-TX
2203,Clackamas County-Crook County-OR-1920,"Crook County, OR",1920,2019,2020,31,742000,112,7328000,-81,-6586000,Clackamas County,Clackamas County-Crook County-OR
2204,Clackamas County-Tarrant County-TX-1920,"Tarrant County, TX",1920,2019,2020,32,1075000,47,1907000,-15,-832000,Clackamas County,Clackamas County-Tarrant County-TX
2205,Clackamas County-Kitsap County-WA-1920,"Kitsap County, WA",1920,2019,2020,50,1407000,34,2134000,16,-727000,Clackamas County,Clackamas County-Kitsap County-WA
2207,Clatsop County-Multnomah County-OR-1920,"Multnomah County, OR",1920,2019,2020,334,18713000,126,4179000,208,14534000,Clatsop County,Clatsop County-Multnomah County-OR
2208,Clatsop County-Washington County-OR-1920,"Washington County, OR",1920,2019,2020,231,12079000,138,4779000,93,7300000,Clatsop County,Clatsop County-Washington County-OR
2209,Clatsop County-Clackamas County-OR-1920,"Clackamas County, OR",1920,2019,2020,136,6613000,45,1476000,91,5137000,Clatsop County,Clatsop County-Clackamas County-OR
2210,Clatsop County-King County-WA-1920,"King County, WA",1920,2019,2020,71,6556000,28,1461000,43,5095000,Clatsop County,Clatsop County-King County-WA
2211,Clatsop County-Clark County-WA-1920,"Clark County, WA",1920,2019,2020,72,2551000,60,1478000,12,1073000,Clatsop County,Clatsop County-Clark County-WA
2212,Clatsop County-Pacific County-WA-1920,"Pacific County, WA",1920,2019,2020,79,1764000,104,3196000,-25,-1432000,Clatsop County,Clatsop County-Pacific County-WA
2213,Clatsop County-Columbia County-OR-1920,"Columbia County, OR",1920,2019,2020,85,1810000,79,2463000,6,-653000,Clatsop County,Clatsop County-Columbia County-OR
2214,Clatsop County-Lane County-OR-1920,"Lane County, OR",1920,2019,2020,56,1386000,56,1264000,0,122000,Clatsop County,Clatsop County-Lane County-OR
2215,Clatsop County-Tillamook County-OR-1920,"Tillamook County, OR",1920,2019,2020,45,1375000,61,1793000,-16,-418000,Clatsop County,Clatsop County-Tillamook County-OR
2216,Clatsop County-Maricopa County-AZ-1920,"Maricopa County, AZ",1920,2019,2020,54,1521000,41,1331000,13,190000,Clatsop County,Clatsop County-Maricopa County-AZ
2217,Clatsop County-Cowlitz County-WA-1920,"Cowlitz County, WA",1920,2019,2020,43,1293000,40,1320000,3,-27000,Clatsop County,Clatsop County-Cowlitz County-WA
2218,Clatsop County-Deschutes County-OR-1920,"Deschutes County, OR",1920,2019,2020,34,1019000,45,1395000,-11,-376000,Clatsop County,Clatsop County-Deschutes County-OR
2220,Columbia County-Washington County-OR-1920,"Washington County, OR",1920,2019,2020,887,30005000,427,12996000,460,17009000,Columbia County,Columbia County-Washington County-OR
2221,Columbia County-Multnomah County-OR-1920,"Multnomah County, OR",1920,2019,2020,627,22801000,273,8772000,354,14029000,Columbia County,Columbia County-Multnomah County-OR
2222,Columbia County-Cowlitz County-WA-1920,"Cowlitz County, WA",1920,2019,2020,248,5352000,227,5390000,21,-38000,Columbia County,Columbia County-Cowlitz County-WA
2223,Columbia County-Clackamas County-OR-1920,"Clackamas County, OR",1920,2019,2020,248,6509000,143,5910000,105,599000,Columbia County,Columbia County-Clackamas County-OR
2224,Columbia County-Clark County-WA-1920,"Clark County, WA",1920,2019,2020,119,3704000,139,4911000,-20,-1207000,Columbia County,Columbia County-Clark County-WA
2225,Columbia County-Clatsop County-OR-1920,"Clatsop County, OR",1920,2019,2020,79,2463000,85,1810000,-6,653000,Columbia County,Columbia County-Clatsop County-OR
2226,Columbia County-Marion County-OR-1920,"Marion County, OR",1920,2019,2020,46,1516000,44,1439000,2,77000,Columbia County,Columbia County-Marion County-OR
2227,Columbia County-Lane County-OR-1920,"Lane County, OR",1920,2019,2020,34,1069000,39,914000,-5,155000,Columbia County,Columbia County-Lane County-OR
2229,Coos County-Lane County-OR-1920,"Lane County, OR",1920,2019,2020,256,6600000,312,8496000,-56,-1896000,Coos County,Coos County-Lane County-OR
2230,Coos County-Douglas County-OR-1920,"Douglas County, OR",1920,2019,2020,193,4082000,231,5388000,-38,-1306000,Coos County,Coos County-Douglas County-OR
2231,Coos County-Multnomah County-OR-1920,"Multnomah County, OR",1920,2019,2020,81,2998000,53,1822000,28,1176000,Coos County,Coos County-Multnomah County-OR
2232,Coos County-Jackson County-OR-1920,"Jackson County, OR",1920,2019,2020,97,2102000,104,2292000,-7,-190000,Coos County,Coos County-Jackson County-OR
2233,Coos County-Curry County-OR-1920,"Curry County, OR",1920,2019,2020,77,2232000,53,964000,24,1268000,Coos County,Coos County-Curry County-OR
2234,Coos County-Deschutes County-OR-1920,"Deschutes County, OR",1920,2019,2020,50,1384000,68,1790000,-18,-406000,Coos County,Coos County-Deschutes County-OR
2235,Coos County-Washington County-OR-1920,"Washington County, OR",1920,2019,2020,61,1587000,39,1521000,22,66000,Coos County,Coos County-Washington County-OR
2236,Coos County-Marion County-OR-1920,"Marion County, OR",1920,2019,2020,59,1367000,62,966000,-3,401000,Coos County,Coos County-Marion County-OR
2237,Coos County-Josephine County-OR-1920,"Josephine County, OR",1920,2019,2020,51,855000,40,1144000,11,-289000,Coos County,Coos County-Josephine County-OR
2238,Coos County-Linn County-OR-1920,"Linn County, OR",1920,2019,2020,42,742000,49,962000,-7,-220000,Coos County,Coos County-Linn County-OR
2239,Coos County-Klamath County-OR-1920,"Klamath County, OR",1920,2019,2020,44,1511000,62,1430000,-18,81000,Coos County,Coos County-Klamath County-OR
2241,Crook County-Deschutes County-OR-1920,"Deschutes County, OR",1920,2019,2020,805,27023000,429,12934000,376,14089000,Crook County,Crook County-Deschutes County-OR
2242,Crook County-Clackamas County-OR-1920,"Clackamas County, OR",1920,2019,2020,112,7328000,31,742000,81,6586000,Crook County,Crook County-Clackamas County-OR
2243,Crook County-Jefferson County-OR-1920,"Jefferson County, OR",1920,2019,2020,108,2678000,85,1879000,23,799000,Crook County,Crook County-Jefferson County-OR
2244,Crook County-Lane County-OR-1920,"Lane County, OR",1920,2019,2020,80,2958000,34,860000,46,2098000,Crook County,Crook County-Lane County-OR
2246,Curry County-Jackson County-OR-1920,"Jackson County, OR",1920,2019,2020,95,5470000,79,2420000,16,3050000,Curry County,Curry County-Jackson County-OR
2247,Curry County-Del Norte County-CA-1920,"Del Norte County, CA",1920,2019,2020,92,2637000,87,1834000,5,803000,Curry County,Curry County-Del Norte County-CA
2248,Curry County-Coos County-OR-1920,"Coos County, OR",1920,2019,2020,53,964000,77,2232000,-24,-1268000,Curry County,Curry County-Coos County-OR
2249,Curry County-Lane County-OR-1920,"Lane County, OR",1920,2019,2020,39,1201000,68,1669000,-29,-468000,Curry County,Curry County-Lane County-OR
2250,Curry County-Josephine County-OR-1920,"Josephine County, OR",1920,2019,2020,45,871000,72,1465000,-27,-594000,Curry County,Curry County-Josephine County-OR
2252,Deschutes County-Multnomah County-OR-1920,"Multnomah County, OR",1920,2019,2020,1181,138328000,421,16497000,760,121831000,Deschutes County,Deschutes County-Multnomah County-OR
2253,Deschutes County-Washington County-OR-1920,"Washington County, OR",1920,2019,2020,732,38625000,325,11853000,407,26772000,Deschutes County,Deschutes County-Washington County-OR
2254,Deschutes County-Lane County-OR-1920,"Lane County, OR",1920,2019,2020,572,23267000,389,11986000,183,11281000,Deschutes County,Deschutes County-Lane County-OR
2255,Deschutes County-Clackamas County-OR-1920,"Clackamas County, OR",1920,2019,2020,604,29842000,278,11629000,326,18213000,Deschutes County,Deschutes County-Clackamas County-OR
2256,Deschutes County-King County-WA-1920,"King County, WA",1920,2019,2020,532,40884000,149,8724000,383,32160000,Deschutes County,Deschutes County-King County-WA
2257,Deschutes County-Los Angeles County-CA-1920,"Los Angeles County, CA",1920,2019,2020,454,40628000,103,3469000,351,37159000,Deschutes County,Deschutes County-Los Angeles County-CA
2258,Deschutes County-Crook County-OR-1920,"Crook County, OR",1920,2019,2020,429,12934000,805,27023000,-376,-14089000,Deschutes County,Deschutes County-Crook County-OR
2259,Deschutes County-Jefferson County-OR-1920,"Jefferson County, OR",1920,2019,2020,432,10756000,572,14887000,-140,-4131000,Deschutes County,Deschutes County-Jefferson County-OR
2260,Deschutes County-Marion County-OR-1920,"Marion County, OR",1920,2019,2020,379,26941000,203,6399000,176,20542000,Deschutes County,Deschutes County-Marion County-OR
2261,Deschutes County-San Diego County-CA-1920,"San Diego County, CA",1920,2019,2020,347,32139000,121,5400000,226,26739000,Deschutes County,Deschutes County-San Diego County-CA
2262,Deschutes County-Orange County-CA-1920,"Orange County, CA",1920,2019,2020,257,15763000,76,3323000,181,12440000,Deschutes County,Deschutes County-Orange County-CA
2263,Deschutes County-Clark County-WA-1920,"Clark County, WA",1920,2019,2020,294,18456000,127,5357000,167,13099000,Deschutes County,Deschutes County-Clark County-WA
2264,Deschutes County-Benton County-OR-1920,"Benton County, OR",1920,2019,2020,182,8150000,97,2664000,85,5486000,Deschutes County,Deschutes County-Benton County-OR
2265,Deschutes County-Santa Clara County-CA-1920,"Santa Clara County, CA",1920,2019,2020,257,31028000,32,2243000,225,28785000,Deschutes County,Deschutes County-Santa Clara County-CA
2266,Deschutes County-Jackson County-OR-1920,"Jackson County, OR",1920,2019,2020,188,7438000,225,7798000,-37,-360000,Deschutes County,Deschutes County-Jackson County-OR
2267,Deschutes County-Maricopa County-AZ-1920,"Maricopa County, AZ",1920,2019,2020,208,9511000,295,22181000,-87,-12670000,Deschutes County,Deschutes County-Maricopa County-AZ
2268,Deschutes County-Klamath County-OR-1920,"Klamath County, OR",1920,2019,2020,246,5315000,174,4993000,72,322000,Deschutes County,Deschutes County-Klamath County-OR
2269,Deschutes County-Alameda County-CA-1920,"Alameda County, CA",1920,2019,2020,204,18678000,31,1240000,173,17438000,Deschutes County,Deschutes County-Alameda County-CA
2270,Deschutes County-Linn County-OR-1920,"Linn County, OR",1920,2019,2020,173,4316000,145,4123000,28,193000,Deschutes County,Deschutes County-Linn County-OR
2271,Deschutes County-Yamhill County-OR-1920,"Yamhill County, OR",1920,2019,2020,162,8602000,77,1949000,85,6653000,Deschutes County,Deschutes County-Yamhill County-OR
2272,Deschutes County-Riverside County-CA-1920,"Riverside County, CA",1920,2019,2020,139,7154000,90,3354000,49,3800000,Deschutes County,Deschutes County-Riverside County-CA
2273,Deschutes County-Polk County-OR-1920,"Polk County, OR",1920,2019,2020,121,4843000,100,3073000,21,1770000,Deschutes County,Deschutes County-Polk County-OR
2274,Deschutes County-Ada County-ID-1920,"Ada County, ID",1920,2019,2020,87,2839000,185,9718000,-98,-6879000,Deschutes County,Deschutes County-Ada County-ID
2275,Deschutes County-Clark County-NV-1920,"Clark County, NV",1920,2019,2020,94,6325000,82,2282000,12,4043000,Deschutes County,Deschutes County-Clark County-NV
2276,Deschutes County-Sacramento County-CA-1920,"Sacramento County, CA",1920,2019,2020,88,5379000,39,1077000,49,4302000,Deschutes County,Deschutes County-Sacramento County-CA
2277,Deschutes County-Pierce County-WA-1920,"Pierce County, WA",1920,2019,2020,96,5728000,58,1987000,38,3741000,Deschutes County,Deschutes County-Pierce County-WA
2278,Deschutes County-Lincoln County-OR-1920,"Lincoln County, OR",1920,2019,2020,75,3856000,72,2141000,3,1715000,Deschutes County,Deschutes County-Lincoln County-OR
2279,Deschutes County-Douglas County-OR-1920,"Douglas County, OR",1920,2019,2020,79,3032000,112,2435000,-33,597000,Deschutes County,Deschutes County-Douglas County-OR
2280,Deschutes County-Salt Lake County-UT-1920,"Salt Lake County, UT",1920,2019,2020,77,4478000,52,1522000,25,2956000,Deschutes County,Deschutes County-Salt Lake County-UT
2281,Deschutes County-Snohomish County-WA-1920,"Snohomish County, WA",1920,2019,2020,85,4690000,42,1429000,43,3261000,Deschutes County,Deschutes County-Snohomish County-WA
2282,Deschutes County-Washoe County-NV-1920,"Washoe County, NV",1920,2019,2020,65,3079000,29,979000,36,2100000,Deschutes County,Deschutes County-Washoe County-NV
2283,Deschutes County-Josephine County-OR-1920,"Josephine County, OR",1920,2019,2020,68,1945000,55,1490000,13,455000,Deschutes County,Deschutes County-Josephine County-OR
2284,Deschutes County-Spokane County-WA-1920,"Spokane County, WA",1920,2019,2020,55,3282000,50,2184000,5,1098000,Deschutes County,Deschutes County-Spokane County-WA
2285,Deschutes County-Coos County-OR-1920,"Coos County, OR",1920,2019,2020,68,1790000,50,1384000,18,406000,Deschutes County,Deschutes County-Coos County-OR
2286,Deschutes County-Umatilla County-OR-1920,"Umatilla County, OR",1920,2019,2020,50,2464000,47,1068000,3,1396000,Deschutes County,Deschutes County-Umatilla County-OR
2287,Deschutes County-Clatsop County-OR-1920,"Clatsop County, OR",1920,2019,2020,45,1395000,34,1019000,11,376000,Deschutes County,Deschutes County-Clatsop County-OR
2288,Deschutes County-Harris County-TX-1920,"Harris County, TX",1920,2019,2020,46,2826000,38,1715000,8,1111000,Deschutes County,Deschutes County-Harris County-TX
2289,Deschutes County-Pima County-AZ-1920,"Pima County, AZ",1920,2019,2020,53,1770000,131,7314000,-78,-5544000,Deschutes County,Deschutes County-Pima County-AZ
2290,Deschutes County-Hawaii County-HI-1920,"Hawaii County, HI",1920,2019,2020,40,1028000,45,1636000,-5,-608000,Deschutes County,Deschutes County-Hawaii County-HI
2291,Deschutes County-Maui County-HI-1920,"Maui County, HI",1920,2019,2020,28,1160000,41,1003000,-13,157000,Deschutes County,Deschutes County-Maui County-HI
2292,Deschutes County-Canyon County-ID-1920,"Canyon County, ID",1920,2019,2020,36,1023000,78,1880000,-42,-857000,Deschutes County,Deschutes County-Canyon County-ID
2294,Douglas County-Lane County-OR-1920,"Lane County, OR",1920,2019,2020,580,12756000,497,12552000,83,204000,Douglas County,Douglas County-Lane County-OR
2295,Douglas County-Coos County-OR-1920,"Coos County, OR",1920,2019,2020,231,5388000,193,4082000,38,1306000,Douglas County,Douglas County-Coos County-OR
2296,Douglas County-Jackson County-OR-1920,"Jackson County, OR",1920,2019,2020,188,3916000,152,3901000,36,15000,Douglas County,Douglas County-Jackson County-OR
2297,Douglas County-Multnomah County-OR-1920,"Multnomah County, OR",1920,2019,2020,134,3469000,65,1511000,69,1958000,Douglas County,Douglas County-Multnomah County-OR
2298,Douglas County-Washington County-OR-1920,"Washington County, OR",1920,2019,2020,133,4293000,67,1779000,66,2514000,Douglas County,Douglas County-Washington County-OR
2299,Douglas County-Josephine County-OR-1920,"Josephine County, OR",1920,2019,2020,136,2941000,125,1982000,11,959000,Douglas County,Douglas County-Josephine County-OR
2300,Douglas County-Marion County-OR-1920,"Marion County, OR",1920,2019,2020,121,3428000,86,2370000,35,1058000,Douglas County,Douglas County-Marion County-OR
2301,Douglas County-Deschutes County-OR-1920,"Deschutes County, OR",1920,2019,2020,112,2435000,79,3032000,33,-597000,Douglas County,Douglas County-Deschutes County-OR
2302,Douglas County-Clackamas County-OR-1920,"Clackamas County, OR",1920,2019,2020,105,3011000,51,1286000,54,1725000,Douglas County,Douglas County-Clackamas County-OR
2303,Douglas County-Linn County-OR-1920,"Linn County, OR",1920,2019,2020,77,1538000,84,2180000,-7,-642000,Douglas County,Douglas County-Linn County-OR
2304,Douglas County-Benton County-OR-1920,"Benton County, OR",1920,2019,2020,61,1337000,46,1386000,15,-49000,Douglas County,Douglas County-Benton County-OR
2305,Douglas County-Maricopa County-AZ-1920,"Maricopa County, AZ",1920,2019,2020,73,2126000,54,1328000,19,798000,Douglas County,Douglas County-Maricopa County-AZ
2306,Douglas County-Klamath County-OR-1920,"Klamath County, OR",1920,2019,2020,64,1114000,48,1371000,16,-257000,Douglas County,Douglas County-Klamath County-OR
2307,Douglas County-Clark County-WA-1920,"Clark County, WA",1920,2019,2020,54,1486000,35,1643000,19,-157000,Douglas County,Douglas County-Clark County-WA
2308,Douglas County-Clark County-NV-1920,"Clark County, NV",1920,2019,2020,35,1076000,48,1211000,-13,-135000,Douglas County,Douglas County-Clark County-NV
2313,Hood River County-Multnomah County-OR-1920,"Multnomah County, OR",1920,2019,2020,277,17575000,138,4735000,139,12840000,Hood River County,Hood River County-Multnomah County-OR
2314,Hood River County-Wasco County-OR-1920,"Wasco County, OR",1920,2019,2020,144,4389000,269,7360000,-125,-2971000,Hood River County,Hood River County-Wasco County-OR
2315,Hood River County-Klickitat County-WA-1920,"Klickitat County, WA",1920,2019,2020,93,3381000,168,7107000,-75,-3726000,Hood River County,Hood River County-Klickitat County-WA
2316,Hood River County-Washington County-OR-1920,"Washington County, OR",1920,2019,2020,60,2404000,43,1569000,17,835000,Hood River County,Hood River County-Washington County-OR
2318,Jackson County-Josephine County-OR-1920,"Josephine County, OR",1920,2019,2020,956,22358000,1120,23422000,-164,-1064000,Jackson County,Jackson County-Josephine County-OR
2319,Jackson County-Los Angeles County-CA-1920,"Los Angeles County, CA",1920,2019,2020,344,17796000,126,3984000,218,13812000,Jackson County,Jackson County-Los Angeles County-CA
2320,Jackson County-Multnomah County-OR-1920,"Multnomah County, OR",1920,2019,2020,263,9285000,275,12014000,-12,-2729000,Jackson County,Jackson County-Multnomah County-OR
2321,Jackson County-Lane County-OR-1920,"Lane County, OR",1920,2019,2020,278,7091000,315,11756000,-37,-4665000,Jackson County,Jackson County-Lane County-OR
2322,Jackson County-Klamath County-OR-1920,"Klamath County, OR",1920,2019,2020,287,8548000,275,5610000,12,2938000,Jackson County,Jackson County-Klamath County-OR
2323,Jackson County-Washington County-OR-1920,"Washington County, OR",1920,2019,2020,227,7950000,241,6158000,-14,1792000,Jackson County,Jackson County-Washington County-OR
2324,Jackson County-Deschutes County-OR-1920,"Deschutes County, OR",1920,2019,2020,225,7798000,188,7438000,37,360000,Jackson County,Jackson County-Deschutes County-OR
2325,Jackson County-Clackamas County-OR-1920,"Clackamas County, OR",1920,2019,2020,195,6393000,143,5075000,52,1318000,Jackson County,Jackson County-Clackamas County-OR
2326,Jackson County-Maricopa County-AZ-1920,"Maricopa County, AZ",1920,2019,2020,173,5655000,198,6033000,-25,-378000,Jackson County,Jackson County-Maricopa County-AZ
2327,Jackson County-San Diego County-CA-1920,"San Diego County, CA",1920,2019,2020,172,6454000,95,3375000,77,3079000,Jackson County,Jackson County-San Diego County-CA
2328,Jackson County-Siskiyou County-CA-1920,"Siskiyou County, CA",1920,2019,2020,166,4011000,111,2562000,55,1449000,Jackson County,Jackson County-Siskiyou County-CA
2329,Jackson County-Douglas County-OR-1920,"Douglas County, OR",1920,2019,2020,152,3901000,188,3916000,-36,-15000,Jackson County,Jackson County-Douglas County-OR
2330,Jackson County-Alameda County-CA-1920,"Alameda County, CA",1920,2019,2020,153,10080000,30,768000,123,9312000,Jackson County,Jackson County-Alameda County-CA
2331,Jackson County-Clark County-NV-1920,"Clark County, NV",1920,2019,2020,132,4639000,81,2643000,51,1996000,Jackson County,Jackson County-Clark County-NV
2332,Jackson County-King County-WA-1920,"King County, WA",1920,2019,2020,115,5893000,117,6567000,-2,-674000,Jackson County,Jackson County-King County-WA
2333,Jackson County-Sonoma County-CA-1920,"Sonoma County, CA",1920,2019,2020,108,5416000,43,1562000,65,3854000,Jackson County,Jackson County-Sonoma County-CA
2334,Jackson County-Shasta County-CA-1920,"Shasta County, CA",1920,2019,2020,109,3503000,69,1355000,40,2148000,Jackson County,Jackson County-Shasta County-CA
2335,Jackson County-Sacramento County-CA-1920,"Sacramento County, CA",1920,2019,2020,110,3059000,49,1858000,61,1201000,Jackson County,Jackson County-Sacramento County-CA
2336,Jackson County-Coos County-OR-1920,"Coos County, OR",1920,2019,2020,104,2292000,97,2102000,7,190000,Jackson County,Jackson County-Coos County-OR
2337,Jackson County-Marion County-OR-1920,"Marion County, OR",1920,2019,2020,106,3267000,125,3568000,-19,-301000,Jackson County,Jackson County-Marion County-OR
2338,Jackson County-Riverside County-CA-1920,"Riverside County, CA",1920,2019,2020,120,4027000,62,1916000,58,2111000,Jackson County,Jackson County-Riverside County-CA
2339,Jackson County-Contra Costa County-CA-1920,"Contra Costa County, CA",1920,2019,2020,105,3314000,63,1381000,42,1933000,Jackson County,Jackson County-Contra Costa County-CA
2340,Jackson County-Orange County-CA-1920,"Orange County, CA",1920,2019,2020,84,2325000,55,1098000,29,1227000,Jackson County,Jackson County-Orange County-CA
2341,Jackson County-Washoe County-NV-1920,"Washoe County, NV",1920,2019,2020,78,2347000,54,2444000,24,-97000,Jackson County,Jackson County-Washoe County-NV
2342,Jackson County-Humboldt County-CA-1920,"Humboldt County, CA",1920,2019,2020,83,2466000,33,944000,50,1522000,Jackson County,Jackson County-Humboldt County-CA
2343,Jackson County-Curry County-OR-1920,"Curry County, OR",1920,2019,2020,79,2420000,95,5470000,-16,-3050000,Jackson County,Jackson County-Curry County-OR
2344,Jackson County-Clark County-WA-1920,"Clark County, WA",1920,2019,2020,86,3171000,87,3007000,-1,164000,Jackson County,Jackson County-Clark County-WA
2345,Jackson County-Butte County-CA-1920,"Butte County, CA",1920,2019,2020,74,1975000,26,712000,48,1263000,Jackson County,Jackson County-Butte County-CA
2346,Jackson County-San Bernardino County-CA-1920,"San Bernardino County, CA",1920,2019,2020,84,2324000,33,1046000,51,1278000,Jackson County,Jackson County-San Bernardino County-CA
2347,Jackson County-Pierce County-WA-1920,"Pierce County, WA",1920,2019,2020,76,1858000,55,1450000,21,408000,Jackson County,Jackson County-Pierce County-WA
2348,Jackson County-Benton County-OR-1920,"Benton County, OR",1920,2019,2020,49,1763000,105,2703000,-56,-940000,Jackson County,Jackson County-Benton County-OR
2349,Jackson County-Ada County-ID-1920,"Ada County, ID",1920,2019,2020,51,1481000,62,2148000,-11,-667000,Jackson County,Jackson County-Ada County-ID
2350,Jackson County-Snohomish County-WA-1920,"Snohomish County, WA",1920,2019,2020,52,2002000,38,1162000,14,840000,Jackson County,Jackson County-Snohomish County-WA
2351,Jackson County-Linn County-OR-1920,"Linn County, OR",1920,2019,2020,52,1302000,77,1660000,-25,-358000,Jackson County,Jackson County-Linn County-OR
2352,Jackson County-Pima County-AZ-1920,"Pima County, AZ",1920,2019,2020,38,1592000,60,1905000,-22,-313000,Jackson County,Jackson County-Pima County-AZ
2353,Jackson County-Yamhill County-OR-1920,"Yamhill County, OR",1920,2019,2020,37,1319000,30,1204000,7,115000,Jackson County,Jackson County-Yamhill County-OR
2355,Jefferson County-Deschutes County-OR-1920,"Deschutes County, OR",1920,2019,2020,572,14887000,432,10756000,140,4131000,Jefferson County,Jefferson County-Deschutes County-OR
2356,Jefferson County-Clackamas County-OR-1920,"Clackamas County, OR",1920,2019,2020,110,3877000,50,1031000,60,2846000,Jefferson County,Jefferson County-Clackamas County-OR
2357,Jefferson County-Crook County-OR-1920,"Crook County, OR",1920,2019,2020,85,1879000,108,2678000,-23,-799000,Jefferson County,Jefferson County-Crook County-OR
2358,Jefferson County-Multnomah County-OR-1920,"Multnomah County, OR",1920,2019,2020,64,3577000,32,973000,32,2604000,Jefferson County,Jefferson County-Multnomah County-OR
2359,Jefferson County-Marion County-OR-1920,"Marion County, OR",1920,2019,2020,45,904000,76,1128000,-31,-224000,Jefferson County,Jefferson County-Marion County-OR
2361,Josephine County-Jackson County-OR-1920,"Jackson County, OR",1920,2019,2020,1120,23422000,956,22358000,164,1064000,Josephine County,Josephine County-Jackson County-OR
2362,Josephine County-Multnomah County-OR-1920,"Multnomah County, OR",1920,2019,2020,120,3253000,52,1747000,68,1506000,Josephine County,Josephine County-Multnomah County-OR
2363,Josephine County-Lane County-OR-1920,"Lane County, OR",1920,2019,2020,86,2297000,121,2710000,-35,-413000,Josephine County,Josephine County-Lane County-OR
2364,Josephine County-Douglas County-OR-1920,"Douglas County, OR",1920,2019,2020,125,1982000,136,2941000,-11,-959000,Josephine County,Josephine County-Douglas County-OR
2365,Josephine County-Clark County-NV-1920,"Clark County, NV",1920,2019,2020,83,1890000,46,973000,37,917000,Josephine County,Josephine County-Clark County-NV
2366,Josephine County-Washington County-OR-1920,"Washington County, OR",1920,2019,2020,72,1988000,56,1619000,16,369000,Josephine County,Josephine County-Washington County-OR
2367,Josephine County-Curry County-OR-1920,"Curry County, OR",1920,2019,2020,72,1465000,45,871000,27,594000,Josephine County,Josephine County-Curry County-OR
2368,Josephine County-Sacramento County-CA-1920,"Sacramento County, CA",1920,2019,2020,62,2309000,40,1092000,22,1217000,Josephine County,Josephine County-Sacramento County-CA
2369,Josephine County-Clackamas County-OR-1920,"Clackamas County, OR",1920,2019,2020,60,2041000,37,914000,23,1127000,Josephine County,Josephine County-Clackamas County-OR
2370,Josephine County-Deschutes County-OR-1920,"Deschutes County, OR",1920,2019,2020,55,1490000,68,1945000,-13,-455000,Josephine County,Josephine County-Deschutes County-OR
2371,Josephine County-Marion County-OR-1920,"Marion County, OR",1920,2019,2020,45,1228000,63,2312000,-18,-1084000,Josephine County,Josephine County-Marion County-OR
2372,Josephine County-Klamath County-OR-1920,"Klamath County, OR",1920,2019,2020,52,1041000,62,1374000,-10,-333000,Josephine County,Josephine County-Klamath County-OR
2373,Josephine County-Coos County-OR-1920,"Coos County, OR",1920,2019,2020,40,1144000,51,855000,-11,289000,Josephine County,Josephine County-Coos County-OR
2375,Klamath County-Jackson County-OR-1920,"Jackson County, OR",1920,2019,2020,275,5610000,287,8548000,-12,-2938000,Klamath County,Klamath County-Jackson County-OR
2376,Klamath County-Deschutes County-OR-1920,"Deschutes County, OR",1920,2019,2020,174,4993000,246,5315000,-72,-322000,Klamath County,Klamath County-Deschutes County-OR
2377,Klamath County-Lane County-OR-1920,"Lane County, OR",1920,2019,2020,119,3248000,158,3891000,-39,-643000,Klamath County,Klamath County-Lane County-OR
2378,Klamath County-Washington County-OR-1920,"Washington County, OR",1920,2019,2020,90,2659000,42,1153000,48,1506000,Klamath County,Klamath County-Washington County-OR
2379,Klamath County-Multnomah County-OR-1920,"Multnomah County, OR",1920,2019,2020,98,2586000,79,1663000,19,923000,Klamath County,Klamath County-Multnomah County-OR
2380,Klamath County-Josephine County-OR-1920,"Josephine County, OR",1920,2019,2020,62,1374000,52,1041000,10,333000,Klamath County,Klamath County-Josephine County-OR
2381,Klamath County-Marion County-OR-1920,"Marion County, OR",1920,2019,2020,61,1555000,57,1404000,4,151000,Klamath County,Klamath County-Marion County-OR
2382,Klamath County-Clackamas County-OR-1920,"Clackamas County, OR",1920,2019,2020,58,1731000,55,1421000,3,310000,Klamath County,Klamath County-Clackamas County-OR
2383,Klamath County-Maricopa County-AZ-1920,"Maricopa County, AZ",1920,2019,2020,67,1255000,46,1031000,21,224000,Klamath County,Klamath County-Maricopa County-AZ
2384,Klamath County-Coos County-OR-1920,"Coos County, OR",1920,2019,2020,62,1430000,44,1511000,18,-81000,Klamath County,Klamath County-Coos County-OR
2385,Klamath County-Douglas County-OR-1920,"Douglas County, OR",1920,2019,2020,48,1371000,64,1114000,-16,257000,Klamath County,Klamath County-Douglas County-OR
2386,Klamath County-Linn County-OR-1920,"Linn County, OR",1920,2019,2020,40,865000,46,890000,-6,-25000,Klamath County,Klamath County-Linn County-OR
2389,Lane County-Multnomah County-OR-1920,"Multnomah County, OR",1920,2019,2020,677,26466000,772,34482000,-95,-8016000,Lane County,Lane County-Multnomah County-OR
2390,Lane County-Linn County-OR-1920,"Linn County, OR",1920,2019,2020,757,17858000,974,24358000,-217,-6500000,Lane County,Lane County-Linn County-OR
2391,Lane County-Douglas County-OR-1920,"Douglas County, OR",1920,2019,2020,497,12552000,580,12756000,-83,-204000,Lane County,Lane County-Douglas County-OR
2392,Lane County-Marion County-OR-1920,"Marion County, OR",1920,2019,2020,416,11669000,525,14509000,-109,-2840000,Lane County,Lane County-Marion County-OR
2393,Lane County-Los Angeles County-CA-1920,"Los Angeles County, CA",1920,2019,2020,436,18842000,138,4161000,298,14681000,Lane County,Lane County-Los Angeles County-CA
2394,Lane County-Washington County-OR-1920,"Washington County, OR",1920,2019,2020,397,14462000,498,16876000,-101,-2414000,Lane County,Lane County-Washington County-OR
2395,Lane County-Deschutes County-OR-1920,"Deschutes County, OR",1920,2019,2020,389,11986000,572,23267000,-183,-11281000,Lane County,Lane County-Deschutes County-OR
2396,Lane County-Benton County-OR-1920,"Benton County, OR",1920,2019,2020,348,10106000,398,7355000,-50,2751000,Lane County,Lane County-Benton County-OR
2397,Lane County-Jackson County-OR-1920,"Jackson County, OR",1920,2019,2020,315,11756000,278,7091000,37,4665000,Lane County,Lane County-Jackson County-OR
2398,Lane County-Clackamas County-OR-1920,"Clackamas County, OR",1920,2019,2020,300,8766000,351,9611000,-51,-845000,Lane County,Lane County-Clackamas County-OR
2399,Lane County-King County-WA-1920,"King County, WA",1920,2019,2020,242,11630000,179,6649000,63,4981000,Lane County,Lane County-King County-WA
2400,Lane County-Coos County-OR-1920,"Coos County, OR",1920,2019,2020,312,8496000,256,6600000,56,1896000,Lane County,Lane County-Coos County-OR
2401,Lane County-Maricopa County-AZ-1920,"Maricopa County, AZ",1920,2019,2020,251,7996000,261,12180000,-10,-4184000,Lane County,Lane County-Maricopa County-AZ
2402,Lane County-San Diego County-CA-1920,"San Diego County, CA",1920,2019,2020,260,10021000,163,5814000,97,4207000,Lane County,Lane County-San Diego County-CA
2403,Lane County-Orange County-CA-1920,"Orange County, CA",1920,2019,2020,186,7796000,93,2366000,93,5430000,Lane County,Lane County-Orange County-CA
2404,Lane County-Santa Clara County-CA-1920,"Santa Clara County, CA",1920,2019,2020,161,11951000,47,2366000,114,9585000,Lane County,Lane County-Santa Clara County-CA
2405,Lane County-Clark County-NV-1920,"Clark County, NV",1920,2019,2020,193,4936000,179,4997000,14,-61000,Lane County,Lane County-Clark County-NV
2406,Lane County-Lincoln County-OR-1920,"Lincoln County, OR",1920,2019,2020,177,4380000,143,5954000,34,-1574000,Lane County,Lane County-Lincoln County-OR
2407,Lane County-Clark County-WA-1920,"Clark County, WA",1920,2019,2020,156,6310000,279,11626000,-123,-5316000,Lane County,Lane County-Clark County-WA
2408,Lane County-Josephine County-OR-1920,"Josephine County, OR",1920,2019,2020,121,2710000,86,2297000,35,413000,Lane County,Lane County-Josephine County-OR
2409,Lane County-Alameda County-CA-1920,"Alameda County, CA",1920,2019,2020,121,6042000,44,1556000,77,4486000,Lane County,Lane County-Alameda County-CA
2410,Lane County-Sacramento County-CA-1920,"Sacramento County, CA",1920,2019,2020,126,4084000,86,2119000,40,1965000,Lane County,Lane County-Sacramento County-CA
2411,Lane County-Riverside County-CA-1920,"Riverside County, CA",1920,2019,2020,148,4957000,102,3189000,46,1768000,Lane County,Lane County-Riverside County-CA
2412,Lane County-Klamath County-OR-1920,"Klamath County, OR",1920,2019,2020,158,3891000,119,3248000,39,643000,Lane County,Lane County-Klamath County-OR
2413,Lane County-Contra Costa County-CA-1920,"Contra Costa County, CA",1920,2019,2020,135,5755000,29,1156000,106,4599000,Lane County,Lane County-Contra Costa County-CA
2414,Lane County-Pierce County-WA-1920,"Pierce County, WA",1920,2019,2020,113,3416000,120,3829000,-7,-413000,Lane County,Lane County-Pierce County-WA
2415,Lane County-Salt Lake County-UT-1920,"Salt Lake County, UT",1920,2019,2020,110,3845000,110,3209000,0,636000,Lane County,Lane County-Salt Lake County-UT
2416,Lane County-Polk County-OR-1920,"Polk County, OR",1920,2019,2020,96,2965000,177,3740000,-81,-775000,Lane County,Lane County-Polk County-OR
2417,Lane County-Sonoma County-CA-1920,"Sonoma County, CA",1920,2019,2020,101,4183000,38,1109000,63,3074000,Lane County,Lane County-Sonoma County-CA
2418,Lane County-Yamhill County-OR-1920,"Yamhill County, OR",1920,2019,2020,94,2986000,69,2244000,25,742000,Lane County,Lane County-Yamhill County-OR
2419,Lane County-Ada County-ID-1920,"Ada County, ID",1920,2019,2020,83,2845000,135,4952000,-52,-2107000,Lane County,Lane County-Ada County-ID
2420,Lane County-Spokane County-WA-1920,"Spokane County, WA",1920,2019,2020,105,2807000,89,2207000,16,600000,Lane County,Lane County-Spokane County-WA
2421,Lane County-Pima County-AZ-1920,"Pima County, AZ",1920,2019,2020,97,2793000,89,3551000,8,-758000,Lane County,Lane County-Pima County-AZ
2422,Lane County-San Bernardino County-CA-1920,"San Bernardino County, CA",1920,2019,2020,98,3169000,93,1427000,5,1742000,Lane County,Lane County-San Bernardino County-CA
2423,Lane County-Washoe County-NV-1920,"Washoe County, NV",1920,2019,2020,82,2624000,49,1172000,33,1452000,Lane County,Lane County-Washoe County-NV
2424,Lane County-San Francisco County-CA-1920,"San Francisco County, CA",1920,2019,2020,67,4301000,29,755000,38,3546000,Lane County,Lane County-San Francisco County-CA
2425,Lane County-Ventura County-CA-1920,"Ventura County, CA",1920,2019,2020,62,3066000,38,1164000,24,1902000,Lane County,Lane County-Ventura County-CA
2426,Lane County-Honolulu County-HI-1920,"Honolulu County, HI",1920,2019,2020,72,2140000,49,1194000,23,946000,Lane County,Lane County-Honolulu County-HI
2427,Lane County-Thurston County-WA-1920,"Thurston County, WA",1920,2019,2020,64,1720000,65,2373000,-1,-653000,Lane County,Lane County-Thurston County-WA
2428,Lane County-Cook County-IL-1920,"Cook County, IL",1920,2019,2020,49,3214000,32,1106000,17,2108000,Lane County,Lane County-Cook County-IL
2429,Lane County-Curry County-OR-1920,"Curry County, OR",1920,2019,2020,68,1669000,39,1201000,29,468000,Lane County,Lane County-Curry County-OR
2430,Lane County-Travis County-TX-1920,"Travis County, TX",1920,2019,2020,46,2064000,57,1632000,-11,432000,Lane County,Lane County-Travis County-TX
2431,Lane County-Snohomish County-WA-1920,"Snohomish County, WA",1920,2019,2020,51,1756000,72,2425000,-21,-669000,Lane County,Lane County-Snohomish County-WA
2432,Lane County-Denver County-CO-1920,"Denver County, CO",1920,2019,2020,39,1453000,38,1042000,1,411000,Lane County,Lane County-Denver County-CO
2433,Lane County-Clatsop County-OR-1920,"Clatsop County, OR",1920,2019,2020,56,1264000,56,1386000,0,-122000,Lane County,Lane County-Clatsop County-OR
2434,Lane County-Kern County-CA-1920,"Kern County, CA",1920,2019,2020,59,1339000,38,890000,21,449000,Lane County,Lane County-Kern County-CA
2435,Lane County-El Paso County-CO-1920,"El Paso County, CO",1920,2019,2020,47,1138000,39,1077000,8,61000,Lane County,Lane County-El Paso County-CO
2436,Lane County-Bernalillo County-NM-1920,"Bernalillo County, NM",1920,2019,2020,45,1437000,34,1708000,11,-271000,Lane County,Lane County-Bernalillo County-NM
2437,Lane County-Anchorage Municipality-AK-1920,"Anchorage Municipality, AK",1920,2019,2020,37,1383000,31,941000,6,442000,Lane County,Lane County-Anchorage Municipality-AK
2438,Lane County-Kitsap County-WA-1920,"Kitsap County, WA",1920,2019,2020,35,1559000,43,977000,-8,582000,Lane County,Lane County-Kitsap County-WA
2439,Lane County-Whatcom County-WA-1920,"Whatcom County, WA",1920,2019,2020,33,1165000,30,958000,3,207000,Lane County,Lane County-Whatcom County-WA
2440,Lane County-Crook County-OR-1920,"Crook County, OR",1920,2019,2020,34,860000,80,2958000,-46,-2098000,Lane County,Lane County-Crook County-OR
2441,Lane County-Hawaii County-HI-1920,"Hawaii County, HI",1920,2019,2020,35,903000,38,965000,-3,-62000,Lane County,Lane County-Hawaii County-HI
2442,Lane County-Columbia County-OR-1920,"Columbia County, OR",1920,2019,2020,39,914000,34,1069000,5,-155000,Lane County,Lane County-Columbia County-OR
2443,Lane County-Harris County-TX-1920,"Harris County, TX",1920,2019,2020,33,1963000,41,1357000,-8,606000,Lane County,Lane County-Harris County-TX
2444,Lane County-Utah County-UT-1920,"Utah County, UT",1920,2019,2020,36,775000,51,1240000,-15,-465000,Lane County,Lane County-Utah County-UT
2446,Lincoln County-Multnomah County-OR-1920,"Multnomah County, OR",1920,2019,2020,196,11890000,116,6148000,80,5742000,Lincoln County,Lincoln County-Multnomah County-OR
2447,Lincoln County-Lane County-OR-1920,"Lane County, OR",1920,2019,2020,143,5954000,177,4380000,-34,1574000,Lincoln County,Lincoln County-Lane County-OR
2448,Lincoln County-Marion County-OR-1920,"Marion County, OR",1920,2019,2020,171,5183000,170,3992000,1,1191000,Lincoln County,Lincoln County-Marion County-OR
2449,Lincoln County-Washington County-OR-1920,"Washington County, OR",1920,2019,2020,156,9939000,120,3714000,36,6225000,Lincoln County,Lincoln County-Washington County-OR
2450,Lincoln County-Clackamas County-OR-1920,"Clackamas County, OR",1920,2019,2020,156,6188000,67,2748000,89,3440000,Lincoln County,Lincoln County-Clackamas County-OR
2451,Lincoln County-Linn County-OR-1920,"Linn County, OR",1920,2019,2020,115,2239000,138,3885000,-23,-1646000,Lincoln County,Lincoln County-Linn County-OR
2452,Lincoln County-Benton County-OR-1920,"Benton County, OR",1920,2019,2020,91,3140000,131,4081000,-40,-941000,Lincoln County,Lincoln County-Benton County-OR
2453,Lincoln County-Deschutes County-OR-1920,"Deschutes County, OR",1920,2019,2020,72,2141000,75,3856000,-3,-1715000,Lincoln County,Lincoln County-Deschutes County-OR
2454,Lincoln County-Polk County-OR-1920,"Polk County, OR",1920,2019,2020,75,2390000,90,2552000,-15,-162000,Lincoln County,Lincoln County-Polk County-OR
2455,Lincoln County-Maricopa County-AZ-1920,"Maricopa County, AZ",1920,2019,2020,68,1469000,69,1772000,-1,-303000,Lincoln County,Lincoln County-Maricopa County-AZ
2456,Lincoln County-Yamhill County-OR-1920,"Yamhill County, OR",1920,2019,2020,59,2201000,82,3326000,-23,-1125000,Lincoln County,Lincoln County-Yamhill County-OR
2457,Lincoln County-King County-WA-1920,"King County, WA",1920,2019,2020,49,2494000,25,1491000,24,1003000,Lincoln County,Lincoln County-King County-WA
2458,Lincoln County-Tillamook County-OR-1920,"Tillamook County, OR",1920,2019,2020,48,1466000,56,2138000,-8,-672000,Lincoln County,Lincoln County-Tillamook County-OR
2459,Lincoln County-Clark County-WA-1920,"Clark County, WA",1920,2019,2020,53,942000,54,2078000,-1,-1136000,Lincoln County,Lincoln County-Clark County-WA
2460,Lincoln County-Clark County-NV-1920,"Clark County, NV",1920,2019,2020,39,1011000,46,1960000,-7,-949000,Lincoln County,Lincoln County-Clark County-NV
2462,Linn County-Marion County-OR-1920,"Marion County, OR",1920,2019,2020,1591,40297000,1161,28930000,430,11367000,Linn County,Linn County-Marion County-OR
2463,Linn County-Benton County-OR-1920,"Benton County, OR",1920,2019,2020,1175,35758000,1270,35011000,-95,747000,Linn County,Linn County-Benton County-OR
2464,Linn County-Lane County-OR-1920,"Lane County, OR",1920,2019,2020,974,24358000,757,17858000,217,6500000,Linn County,Linn County-Lane County-OR
2465,Linn County-Polk County-OR-1920,"Polk County, OR",1920,2019,2020,313,7682000,251,6456000,62,1226000,Linn County,Linn County-Polk County-OR
2466,Linn County-Washington County-OR-1920,"Washington County, OR",1920,2019,2020,203,5516000,166,4012000,37,1504000,Linn County,Linn County-Washington County-OR
2467,Linn County-Multnomah County-OR-1920,"Multnomah County, OR",1920,2019,2020,178,6012000,129,3123000,49,2889000,Linn County,Linn County-Multnomah County-OR
2468,Linn County-Clackamas County-OR-1920,"Clackamas County, OR",1920,2019,2020,141,5458000,113,3851000,28,1607000,Linn County,Linn County-Clackamas County-OR
2469,Linn County-Deschutes County-OR-1920,"Deschutes County, OR",1920,2019,2020,145,4123000,173,4316000,-28,-193000,Linn County,Linn County-Deschutes County-OR
2470,Linn County-Lincoln County-OR-1920,"Lincoln County, OR",1920,2019,2020,138,3885000,115,2239000,23,1646000,Linn County,Linn County-Lincoln County-OR
2471,Linn County-Douglas County-OR-1920,"Douglas County, OR",1920,2019,2020,84,2180000,77,1538000,7,642000,Linn County,Linn County-Douglas County-OR
2472,Linn County-Jackson County-OR-1920,"Jackson County, OR",1920,2019,2020,77,1660000,52,1302000,25,358000,Linn County,Linn County-Jackson County-OR
2473,Linn County-Clark County-WA-1920,"Clark County, WA",1920,2019,2020,87,2148000,72,1659000,15,489000,Linn County,Linn County-Clark County-WA
2474,Linn County-Yamhill County-OR-1920,"Yamhill County, OR",1920,2019,2020,75,1665000,62,1802000,13,-137000,Linn County,Linn County-Yamhill County-OR
2475,Linn County-Maricopa County-AZ-1920,"Maricopa County, AZ",1920,2019,2020,64,1631000,111,3414000,-47,-1783000,Linn County,Linn County-Maricopa County-AZ
2476,Linn County-Coos County-OR-1920,"Coos County, OR",1920,2019,2020,49,962000,42,742000,7,220000,Linn County,Linn County-Coos County-OR
2477,Linn County-Pierce County-WA-1920,"Pierce County, WA",1920,2019,2020,50,1435000,44,1106000,6,329000,Linn County,Linn County-Pierce County-WA
2478,Linn County-Klamath County-OR-1920,"Klamath County, OR",1920,2019,2020,46,890000,40,865000,6,25000,Linn County,Linn County-Klamath County-OR
2480,Malheur County-Payette County-ID-1920,"Payette County, ID",1920,2019,2020,288,4378000,282,5740000,6,-1362000,Malheur County,Malheur County-Payette County-ID
2481,Malheur County-Canyon County-ID-1920,"Canyon County, ID",1920,2019,2020,259,4184000,161,2846000,98,1338000,Malheur County,Malheur County-Canyon County-ID
2482,Malheur County-Ada County-ID-1920,"Ada County, ID",1920,2019,2020,133,2219000,137,4293000,-4,-2074000,Malheur County,Malheur County-Ada County-ID
2483,Malheur County-Washington County-ID-1920,"Washington County, ID",1920,2019,2020,41,839000,54,797000,-13,42000,Malheur County,Malheur County-Washington County-ID
2485,Marion County-Polk County-OR-1920,"Polk County, OR",1920,2019,2020,2388,63718000,2831,76585000,-443,-12867000,Marion County,Marion County-Polk County-OR
2486,Marion County-Clackamas County-OR-1920,"Clackamas County, OR",1920,2019,2020,1807,54967000,1564,48417000,243,6550000,Marion County,Marion County-Clackamas County-OR
2487,Marion County-Washington County-OR-1920,"Washington County, OR",1920,2019,2020,1510,42169000,965,28031000,545,14138000,Marion County,Marion County-Washington County-OR
2488,Marion County-Linn County-OR-1920,"Linn County, OR",1920,2019,2020,1161,28930000,1591,40297000,-430,-11367000,Marion County,Marion County-Linn County-OR
2489,Marion County-Multnomah County-OR-1920,"Multnomah County, OR",1920,2019,2020,945,29828000,799,26174000,146,3654000,Marion County,Marion County-Multnomah County-OR
2490,Marion County-Lane County-OR-1920,"Lane County, OR",1920,2019,2020,525,14509000,416,11669000,109,2840000,Marion County,Marion County-Lane County-OR
2491,Marion County-Yamhill County-OR-1920,"Yamhill County, OR",1920,2019,2020,478,11416000,433,11202000,45,214000,Marion County,Marion County-Yamhill County-OR
2492,Marion County-Benton County-OR-1920,"Benton County, OR",1920,2019,2020,302,11449000,275,9332000,27,2117000,Marion County,Marion County-Benton County-OR
2493,Marion County-Clark County-WA-1920,"Clark County, WA",1920,2019,2020,314,13944000,317,10680000,-3,3264000,Marion County,Marion County-Clark County-WA
2494,Marion County-Los Angeles County-CA-1920,"Los Angeles County, CA",1920,2019,2020,288,7019000,69,1813000,219,5206000,Marion County,Marion County-Los Angeles County-CA
2495,Marion County-Deschutes County-OR-1920,"Deschutes County, OR",1920,2019,2020,203,6399000,379,26941000,-176,-20542000,Marion County,Marion County-Deschutes County-OR
2496,Marion County-Maricopa County-AZ-1920,"Maricopa County, AZ",1920,2019,2020,194,5428000,266,9552000,-72,-4124000,Marion County,Marion County-Maricopa County-AZ
2497,Marion County-Lincoln County-OR-1920,"Lincoln County, OR",1920,2019,2020,170,3992000,171,5183000,-1,-1191000,Marion County,Marion County-Lincoln County-OR
2498,Marion County-King County-WA-1920,"King County, WA",1920,2019,2020,148,5888000,120,5420000,28,468000,Marion County,Marion County-King County-WA
2499,Marion County-Jackson County-OR-1920,"Jackson County, OR",1920,2019,2020,125,3568000,106,3267000,19,301000,Marion County,Marion County-Jackson County-OR
2500,Marion County-San Diego County-CA-1920,"San Diego County, CA",1920,2019,2020,118,3255000,97,2608000,21,647000,Marion County,Marion County-San Diego County-CA
2501,Marion County-Clark County-NV-1920,"Clark County, NV",1920,2019,2020,129,2813000,126,4849000,3,-2036000,Marion County,Marion County-Clark County-NV
2502,Marion County-Douglas County-OR-1920,"Douglas County, OR",1920,2019,2020,86,2370000,121,3428000,-35,-1058000,Marion County,Marion County-Douglas County-OR
2503,Marion County-Orange County-CA-1920,"Orange County, CA",1920,2019,2020,112,4391000,38,972000,74,3419000,Marion County,Marion County-Orange County-CA
2504,Marion County-Riverside County-CA-1920,"Riverside County, CA",1920,2019,2020,111,2870000,83,2546000,28,324000,Marion County,Marion County-Riverside County-CA
2505,Marion County-Pierce County-WA-1920,"Pierce County, WA",1920,2019,2020,99,2676000,96,2258000,3,418000,Marion County,Marion County-Pierce County-WA
2506,Marion County-San Bernardino County-CA-1920,"San Bernardino County, CA",1920,2019,2020,68,1692000,41,1065000,27,627000,Marion County,Marion County-San Bernardino County-CA
2507,Marion County-Snohomish County-WA-1920,"Snohomish County, WA",1920,2019,2020,83,3634000,63,1886000,20,1748000,Marion County,Marion County-Snohomish County-WA
2508,Marion County-Josephine County-OR-1920,"Josephine County, OR",1920,2019,2020,63,2312000,45,1228000,18,1084000,Marion County,Marion County-Josephine County-OR
2509,Marion County-Santa Clara County-CA-1920,"Santa Clara County, CA",1920,2019,2020,75,3524000,37,1091000,38,2433000,Marion County,Marion County-Santa Clara County-CA
2510,Marion County-Sacramento County-CA-1920,"Sacramento County, CA",1920,2019,2020,78,1925000,46,1033000,32,892000,Marion County,Marion County-Sacramento County-CA
2511,Marion County-Coos County-OR-1920,"Coos County, OR",1920,2019,2020,62,966000,59,1367000,3,-401000,Marion County,Marion County-Coos County-OR
2512,Marion County-Honolulu County-HI-1920,"Honolulu County, HI",1920,2019,2020,97,2417000,47,961000,50,1456000,Marion County,Marion County-Honolulu County-HI
2513,Marion County-Ada County-ID-1920,"Ada County, ID",1920,2019,2020,57,1564000,110,3412000,-53,-1848000,Marion County,Marion County-Ada County-ID
2514,Marion County-Tillamook County-OR-1920,"Tillamook County, OR",1920,2019,2020,68,1511000,59,2273000,9,-762000,Marion County,Marion County-Tillamook County-OR
2515,Marion County-Spokane County-WA-1920,"Spokane County, WA",1920,2019,2020,59,1449000,80,1517000,-21,-68000,Marion County,Marion County-Spokane County-WA
2516,Marion County-Columbia County-OR-1920,"Columbia County, OR",1920,2019,2020,44,1439000,46,1516000,-2,-77000,Marion County,Marion County-Columbia County-OR
2517,Marion County-Klamath County-OR-1920,"Klamath County, OR",1920,2019,2020,57,1404000,61,1555000,-4,-151000,Marion County,Marion County-Klamath County-OR
2518,Marion County-Umatilla County-OR-1920,"Umatilla County, OR",1920,2019,2020,55,1135000,67,1503000,-12,-368000,Marion County,Marion County-Umatilla County-OR
2519,Marion County-Jefferson County-OR-1920,"Jefferson County, OR",1920,2019,2020,76,1128000,45,904000,31,224000,Marion County,Marion County-Jefferson County-OR
2520,Marion County-Pima County-AZ-1920,"Pima County, AZ",1920,2019,2020,52,893000,63,1820000,-11,-927000,Marion County,Marion County-Pima County-AZ
2521,Marion County-Salt Lake County-UT-1920,"Salt Lake County, UT",1920,2019,2020,43,850000,45,1392000,-2,-542000,Marion County,Marion County-Salt Lake County-UT
2522,Marion County-Thurston County-WA-1920,"Thurston County, WA",1920,2019,2020,39,1033000,55,1367000,-16,-334000,Marion County,Marion County-Thurston County-WA
2523,Marion County-Washoe County-NV-1920,"Washoe County, NV",1920,2019,2020,36,751000,55,1431000,-19,-680000,Marion County,Marion County-Washoe County-NV
2524,Marion County-Cowlitz County-WA-1920,"Cowlitz County, WA",1920,2019,2020,39,945000,44,1039000,-5,-94000,Marion County,Marion County-Cowlitz County-WA
2526,Morrow County-Umatilla County-OR-1920,"Umatilla County, OR",1920,2019,2020,322,6940000,306,6732000,16,208000,Morrow County,Morrow County-Umatilla County-OR
2528,Multnomah County-Washington County-OR-1920,"Washington County, OR",1920,2019,2020,6445,329865000,7922,377836000,-1477,-47971000,Multnomah County,Multnomah County-Washington County-OR
2529,Multnomah County-Clackamas County-OR-1920,"Clackamas County, OR",1920,2019,2020,6233,231652000,10731,462807000,-4498,-231155000,Multnomah County,Multnomah County-Clackamas County-OR
2530,Multnomah County-Clark County-WA-1920,"Clark County, WA",1920,2019,2020,2966,118253000,5447,235189000,-2481,-116936000,Multnomah County,Multnomah County-Clark County-WA
2531,Multnomah County-Los Angeles County-CA-1920,"Los Angeles County, CA",1920,2019,2020,1452,85559000,747,37547000,705,48012000,Multnomah County,Multnomah County-Los Angeles County-CA
2532,Multnomah County-King County-WA-1920,"King County, WA",1920,2019,2020,1283,81468000,1027,61943000,256,19525000,Multnomah County,Multnomah County-King County-WA
2533,Multnomah County-San Francisco County-CA-1920,"San Francisco County, CA",1920,2019,2020,885,110494000,216,19833000,669,90661000,Multnomah County,Multnomah County-San Francisco County-CA
2534,Multnomah County-Lane County-OR-1920,"Lane County, OR",1920,2019,2020,772,34482000,677,26466000,95,8016000,Multnomah County,Multnomah County-Lane County-OR
2535,Multnomah County-Marion County-OR-1920,"Marion County, OR",1920,2019,2020,799,26174000,945,29828000,-146,-3654000,Multnomah County,Multnomah County-Marion County-OR
2536,Multnomah County-Alameda County-CA-1920,"Alameda County, CA",1920,2019,2020,702,57313000,183,13922000,519,43391000,Multnomah County,Multnomah County-Alameda County-CA
2537,Multnomah County-San Diego County-CA-1920,"San Diego County, CA",1920,2019,2020,552,21571000,403,19247000,149,2324000,Multnomah County,Multnomah County-San Diego County-CA
2538,Multnomah County-Maricopa County-AZ-1920,"Maricopa County, AZ",1920,2019,2020,479,18458000,669,30018000,-190,-11560000,Multnomah County,Multnomah County-Maricopa County-AZ
2539,Multnomah County-Orange County-CA-1920,"Orange County, CA",1920,2019,2020,483,21301000,274,20261000,209,1040000,Multnomah County,Multnomah County-Orange County-CA
2540,Multnomah County-Deschutes County-OR-1920,"Deschutes County, OR",1920,2019,2020,421,16497000,1181,138328000,-760,-121831000,Multnomah County,Multnomah County-Deschutes County-OR
2541,Multnomah County-Kings County-NY-1920,"Kings County, NY",1920,2019,2020,416,31489000,143,6775000,273,24714000,Multnomah County,Multnomah County-Kings County-NY
2542,Multnomah County-Santa Clara County-CA-1920,"Santa Clara County, CA",1920,2019,2020,465,44146000,195,14126000,270,30020000,Multnomah County,Multnomah County-Santa Clara County-CA
2543,Multnomah County-Benton County-OR-1920,"Benton County, OR",1920,2019,2020,369,12100000,267,10562000,102,1538000,Multnomah County,Multnomah County-Benton County-OR
2544,Multnomah County-Cook County-IL-1920,"Cook County, IL",1920,2019,2020,367,24115000,287,15019000,80,9096000,Multnomah County,Multnomah County-Cook County-IL
2545,Multnomah County-Clark County-NV-1920,"Clark County, NV",1920,2019,2020,343,13407000,398,12304000,-55,1103000,Multnomah County,Multnomah County-Clark County-NV
2546,Multnomah County-Jackson County-OR-1920,"Jackson County, OR",1920,2019,2020,275,12014000,263,9285000,12,2729000,Multnomah County,Multnomah County-Jackson County-OR
2547,Multnomah County-Yamhill County-OR-1920,"Yamhill County, OR",1920,2019,2020,289,8325000,465,27297000,-176,-18972000,Multnomah County,Multnomah County-Yamhill County-OR
2548,Multnomah County-Pierce County-WA-1920,"Pierce County, WA",1920,2019,2020,272,15441000,344,11010000,-72,4431000,Multnomah County,Multnomah County-Pierce County-WA
2549,Multnomah County-Columbia County-OR-1920,"Columbia County, OR",1920,2019,2020,273,8772000,627,22801000,-354,-14029000,Multnomah County,Multnomah County-Columbia County-OR
2550,Multnomah County-Contra Costa County-CA-1920,"Contra Costa County, CA",1920,2019,2020,261,17971000,97,4477000,164,13494000,Multnomah County,Multnomah County-Contra Costa County-CA
2551,Multnomah County-Denver County-CO-1920,"Denver County, CO",1920,2019,2020,196,9560000,195,11134000,1,-1574000,Multnomah County,Multnomah County-Denver County-CO
2552,Multnomah County-San Mateo County-CA-1920,"San Mateo County, CA",1920,2019,2020,261,21745000,77,5004000,184,16741000,Multnomah County,Multnomah County-San Mateo County-CA
2553,Multnomah County-New York County-NY-1920,"New York County, NY",1920,2019,2020,214,19842000,110,7461000,104,12381000,Multnomah County,Multnomah County-New York County-NY
2554,Multnomah County-Honolulu County-HI-1920,"Honolulu County, HI",1920,2019,2020,233,7551000,168,6627000,65,924000,Multnomah County,Multnomah County-Honolulu County-HI
2555,Multnomah County-Salt Lake County-UT-1920,"Salt Lake County, UT",1920,2019,2020,205,7877000,162,6551000,43,1326000,Multnomah County,Multnomah County-Salt Lake County-UT
2556,Multnomah County-Sacramento County-CA-1920,"Sacramento County, CA",1920,2019,2020,196,8235000,229,9344000,-33,-1109000,Multnomah County,Multnomah County-Sacramento County-CA
2557,Multnomah County-Travis County-TX-1920,"Travis County, TX",1920,2019,2020,190,14527000,201,24842000,-11,-10315000,Multnomah County,Multnomah County-Travis County-TX
2558,Multnomah County-District of Columbia-DC-1920,"District of Columbia, DC",1920,2019,2020,182,13881000,69,3424000,113,10457000,Multnomah County,Multnomah County-District of Columbia-DC
2559,Multnomah County-Hennepin County-MN-1920,"Hennepin County, MN",1920,2019,2020,173,10576000,153,6839000,20,3737000,Multnomah County,Multnomah County-Hennepin County-MN
2560,Multnomah County-Riverside County-CA-1920,"Riverside County, CA",1920,2019,2020,193,10296000,213,16229000,-20,-5933000,Multnomah County,Multnomah County-Riverside County-CA
2561,Multnomah County-San Bernardino County-CA-1920,"San Bernardino County, CA",1920,2019,2020,193,4442000,109,2615000,84,1827000,Multnomah County,Multnomah County-San Bernardino County-CA
2562,Multnomah County-Middlesex County-MA-1920,"Middlesex County, MA",1920,2019,2020,138,8739000,67,4669000,71,4070000,Multnomah County,Multnomah County-Middlesex County-MA
2563,Multnomah County-Cowlitz County-WA-1920,"Cowlitz County, WA",1920,2019,2020,172,4969000,310,10885000,-138,-5916000,Multnomah County,Multnomah County-Cowlitz County-WA
2564,Multnomah County-Harris County-TX-1920,"Harris County, TX",1920,2019,2020,153,8200000,158,6319000,-5,1881000,Multnomah County,Multnomah County-Harris County-TX
2565,Multnomah County-Ada County-ID-1920,"Ada County, ID",1920,2019,2020,153,4745000,257,11235000,-104,-6490000,Multnomah County,Multnomah County-Ada County-ID
2566,Multnomah County-Thurston County-WA-1920,"Thurston County, WA",1920,2019,2020,143,5370000,145,6245000,-2,-875000,Multnomah County,Multnomah County-Thurston County-WA
2567,Multnomah County-Snohomish County-WA-1920,"Snohomish County, WA",1920,2019,2020,164,6220000,162,6822000,2,-602000,Multnomah County,Multnomah County-Snohomish County-WA
2568,Multnomah County-Polk County-OR-1920,"Polk County, OR",1920,2019,2020,117,4293000,239,8940000,-122,-4647000,Multnomah County,Multnomah County-Polk County-OR
2569,Multnomah County-Linn County-OR-1920,"Linn County, OR",1920,2019,2020,129,3123000,178,6012000,-49,-2889000,Multnomah County,Multnomah County-Linn County-OR
2570,Multnomah County-Suffolk County-MA-1920,"Suffolk County, MA",1920,2019,2020,120,9196000,73,5885000,47,3311000,Multnomah County,Multnomah County-Suffolk County-MA
2571,Multnomah County-Hood River County-OR-1920,"Hood River County, OR",1920,2019,2020,138,4735000,277,17575000,-139,-12840000,Multnomah County,Multnomah County-Hood River County-OR
2572,Multnomah County-Marin County-CA-1920,"Marin County, CA",1920,2019,2020,150,12225000,44,4751000,106,7474000,Multnomah County,Multnomah County-Marin County-CA
2573,Multnomah County-Philadelphia County-PA-1920,"Philadelphia County, PA",1920,2019,2020,121,7148000,95,7140000,26,8000,Multnomah County,Multnomah County-Philadelphia County-PA
2574,Multnomah County-Pima County-AZ-1920,"Pima County, AZ",1920,2019,2020,120,6115000,157,6498000,-37,-383000,Multnomah County,Multnomah County-Pima County-AZ
2575,Multnomah County-Washoe County-NV-1920,"Washoe County, NV",1920,2019,2020,122,4819000,75,3569000,47,1250000,Multnomah County,Multnomah County-Washoe County-NV
2576,Multnomah County-Clatsop County-OR-1920,"Clatsop County, OR",1920,2019,2020,126,4179000,334,18713000,-208,-14534000,Multnomah County,Multnomah County-Clatsop County-OR
2577,Multnomah County-Santa Cruz County-CA-1920,"Santa Cruz County, CA",1920,2019,2020,110,6006000,65,3050000,45,2956000,Multnomah County,Multnomah County-Santa Cruz County-CA
2578,Multnomah County-Dallas County-TX-1920,"Dallas County, TX",1920,2019,2020,118,8528000,118,6352000,0,2176000,Multnomah County,Multnomah County-Dallas County-TX
2579,Multnomah County-Spokane County-WA-1920,"Spokane County, WA",1920,2019,2020,120,4284000,290,10505000,-170,-6221000,Multnomah County,Multnomah County-Spokane County-WA
2580,Multnomah County-Whatcom County-WA-1920,"Whatcom County, WA",1920,2019,2020,119,3908000,155,6970000,-36,-3062000,Multnomah County,Multnomah County-Whatcom County-WA
2581,Multnomah County-Lincoln County-OR-1920,"Lincoln County, OR",1920,2019,2020,116,6148000,196,11890000,-80,-5742000,Multnomah County,Multnomah County-Lincoln County-OR
2582,Multnomah County-Queens County-NY-1920,"Queens County, NY",1920,2019,2020,119,5947000,44,1880000,75,4067000,Multnomah County,Multnomah County-Queens County-NY
2583,Multnomah County-Sonoma County-CA-1920,"Sonoma County, CA",1920,2019,2020,105,5730000,63,2841000,42,2889000,Multnomah County,Multnomah County-Sonoma County-CA
2584,Multnomah County-Bernalillo County-NM-1920,"Bernalillo County, NM",1920,2019,2020,96,3671000,84,3094000,12,577000,Multnomah County,Multnomah County-Bernalillo County-NM
2585,Multnomah County-Santa Barbara County-CA-1920,"Santa Barbara County, CA",1920,2019,2020,87,3816000,67,3188000,20,628000,Multnomah County,Multnomah County-Santa Barbara County-CA
2586,Multnomah County-Fulton County-GA-1920,"Fulton County, GA",1920,2019,2020,79,5288000,55,4561000,24,727000,Multnomah County,Multnomah County-Fulton County-GA
2587,Multnomah County-Allegheny County-PA-1920,"Allegheny County, PA",1920,2019,2020,94,3476000,70,5047000,24,-1571000,Multnomah County,Multnomah County-Allegheny County-PA
2588,Multnomah County-Ventura County-CA-1920,"Ventura County, CA",1920,2019,2020,94,3554000,72,3265000,22,289000,Multnomah County,Multnomah County-Ventura County-CA
2589,Multnomah County-Franklin County-OH-1920,"Franklin County, OH",1920,2019,2020,85,4375000,101,3379000,-16,996000,Multnomah County,Multnomah County-Franklin County-OH
2590,Multnomah County-Anchorage Municipality-AK-1920,"Anchorage Municipality, AK",1920,2019,2020,88,3407000,72,3038000,16,369000,Multnomah County,Multnomah County-Anchorage Municipality-AK
2591,Multnomah County-Fresno County-CA-1920,"Fresno County, CA",1920,2019,2020,103,2797000,45,1220000,58,1577000,Multnomah County,Multnomah County-Fresno County-CA
2592,Multnomah County-Boulder County-CO-1920,"Boulder County, CO",1920,2019,2020,61,3113000,75,4052000,-14,-939000,Multnomah County,Multnomah County-Boulder County-CO
2593,Multnomah County-Wasco County-OR-1920,"Wasco County, OR",1920,2019,2020,89,2267000,122,6393000,-33,-4126000,Multnomah County,Multnomah County-Wasco County-OR
2594,Multnomah County-Miami-Dade County-FL-1920,"Miami-Dade County, FL",1920,2019,2020,86,4486000,77,3813000,9,673000,Multnomah County,Multnomah County-Miami-Dade County-FL
2595,Multnomah County-Tarrant County-TX-1920,"Tarrant County, TX",1920,2019,2020,73,2593000,90,5060000,-17,-2467000,Multnomah County,Multnomah County-Tarrant County-TX
2596,Multnomah County-San Luis Obispo County-CA-1920,"San Luis Obispo County, CA",1920,2019,2020,66,2310000,54,1843000,12,467000,Multnomah County,Multnomah County-San Luis Obispo County-CA
2597,Multnomah County-El Paso County-CO-1920,"El Paso County, CO",1920,2019,2020,77,2353000,76,2400000,1,-47000,Multnomah County,Multnomah County-El Paso County-CO
2598,Multnomah County-Marion County-IN-1920,"Marion County, IN",1920,2019,2020,67,3448000,35,1326000,32,2122000,Multnomah County,Multnomah County-Marion County-IN
2599,Multnomah County-Cuyahoga County-OH-1920,"Cuyahoga County, OH",1920,2019,2020,65,3612000,52,2205000,13,1407000,Multnomah County,Multnomah County-Cuyahoga County-OH
2600,Multnomah County-Davidson County-TN-1920,"Davidson County, TN",1920,2019,2020,68,4086000,63,3764000,5,322000,Multnomah County,Multnomah County-Davidson County-TN
2601,Multnomah County-Kitsap County-WA-1920,"Kitsap County, WA",1920,2019,2020,66,2170000,120,5610000,-54,-3440000,Multnomah County,Multnomah County-Kitsap County-WA
2602,Multnomah County-Milwaukee County-WI-1920,"Milwaukee County, WI",1920,2019,2020,64,2713000,62,1975000,2,738000,Multnomah County,Multnomah County-Milwaukee County-WI
2603,Multnomah County-Oakland County-MI-1920,"Oakland County, MI",1920,2019,2020,70,3985000,45,2473000,25,1512000,Multnomah County,Multnomah County-Oakland County-MI
2604,Multnomah County-Klamath County-OR-1920,"Klamath County, OR",1920,2019,2020,79,1663000,98,2586000,-19,-923000,Multnomah County,Multnomah County-Klamath County-OR
2605,Multnomah County-Jefferson County-CO-1920,"Jefferson County, CO",1920,2019,2020,62,3338000,64,4555000,-2,-1217000,Multnomah County,Multnomah County-Jefferson County-CO
2606,Multnomah County-Larimer County-CO-1920,"Larimer County, CO",1920,2019,2020,58,2047000,68,3034000,-10,-987000,Multnomah County,Multnomah County-Larimer County-CO
2607,Multnomah County-Yakima County-WA-1920,"Yakima County, WA",1920,2019,2020,93,1994000,59,1626000,34,368000,Multnomah County,Multnomah County-Yakima County-WA
2608,Multnomah County-Dane County-WI-1920,"Dane County, WI",1920,2019,2020,76,3925000,48,2225000,28,1700000,Multnomah County,Multnomah County-Dane County-WI
2609,Multnomah County-Hillsborough County-FL-1920,"Hillsborough County, FL",1920,2019,2020,77,2542000,85,2601000,-8,-59000,Multnomah County,Multnomah County-Hillsborough County-FL
2610,Multnomah County-Jackson County-MO-1920,"Jackson County, MO",1920,2019,2020,70,2892000,55,1676000,15,1216000,Multnomah County,Multnomah County-Jackson County-MO
2611,Multnomah County-Arapahoe County-CO-1920,"Arapahoe County, CO",1920,2019,2020,74,2844000,86,2904000,-12,-60000,Multnomah County,Multnomah County-Arapahoe County-CO
2612,Multnomah County-Pinellas County-FL-1920,"Pinellas County, FL",1920,2019,2020,60,2965000,46,2117000,14,848000,Multnomah County,Multnomah County-Pinellas County-FL
2613,Multnomah County-Gallatin County-MT-1920,"Gallatin County, MT",1920,2019,2020,53,1527000,45,2358000,8,-831000,Multnomah County,Multnomah County-Gallatin County-MT
2614,Multnomah County-Tillamook County-OR-1920,"Tillamook County, OR",1920,2019,2020,74,2001000,255,14922000,-181,-12921000,Multnomah County,Multnomah County-Tillamook County-OR
2615,Multnomah County-Benton County-WA-1920,"Benton County, WA",1920,2019,2020,70,3026000,92,4128000,-22,-1102000,Multnomah County,Multnomah County-Benton County-WA
2616,Multnomah County-San Joaquin County-CA-1920,"San Joaquin County, CA",1920,2019,2020,70,1975000,47,1197000,23,778000,Multnomah County,Multnomah County-San Joaquin County-CA
2617,Multnomah County-Broward County-FL-1920,"Broward County, FL",1920,2019,2020,58,2416000,32,1688000,26,728000,Multnomah County,Multnomah County-Broward County-FL
2618,Multnomah County-Orange County-FL-1920,"Orange County, FL",1920,2019,2020,57,2247000,60,2259000,-3,-12000,Multnomah County,Multnomah County-Orange County-FL
2619,Multnomah County-Orleans Parish-LA-1920,"Orleans Parish, LA",1920,2019,2020,61,2212000,46,1681000,15,531000,Multnomah County,Multnomah County-Orleans Parish-LA
2620,Multnomah County-Douglas County-OR-1920,"Douglas County, OR",1920,2019,2020,65,1511000,134,3469000,-69,-1958000,Multnomah County,Multnomah County-Douglas County-OR
2621,Multnomah County-Humboldt County-CA-1920,"Humboldt County, CA",1920,2019,2020,50,1245000,51,1635000,-1,-390000,Multnomah County,Multnomah County-Humboldt County-CA
2622,Multnomah County-Washtenaw County-MI-1920,"Washtenaw County, MI",1920,2019,2020,61,3802000,27,1186000,34,2616000,Multnomah County,Multnomah County-Washtenaw County-MI
2623,Multnomah County-Missoula County-MT-1920,"Missoula County, MT",1920,2019,2020,54,1681000,66,2724000,-12,-1043000,Multnomah County,Multnomah County-Missoula County-MT
2624,Multnomah County-Baltimore city-MD-1920,"Baltimore city, MD",1920,2019,2020,58,2725000,30,1026000,28,1699000,Multnomah County,Multnomah County-Baltimore city-MD
2625,Multnomah County-Maui County-HI-1920,"Maui County, HI",1920,2019,2020,52,1931000,62,2264000,-10,-333000,Multnomah County,Multnomah County-Maui County-HI
2626,Multnomah County-Josephine County-OR-1920,"Josephine County, OR",1920,2019,2020,52,1747000,120,3253000,-68,-1506000,Multnomah County,Multnomah County-Josephine County-OR
2627,Multnomah County-Umatilla County-OR-1920,"Umatilla County, OR",1920,2019,2020,67,1770000,81,2590000,-14,-820000,Multnomah County,Multnomah County-Umatilla County-OR
2628,Multnomah County-Wake County-NC-1920,"Wake County, NC",1920,2019,2020,56,2381000,55,2188000,1,193000,Multnomah County,Multnomah County-Wake County-NC
2629,Multnomah County-Montgomery County-MD-1920,"Montgomery County, MD",1920,2019,2020,50,2794000,35,2536000,15,258000,Multnomah County,Multnomah County-Montgomery County-MD
2630,Multnomah County-Bexar County-TX-1920,"Bexar County, TX",1920,2019,2020,62,2744000,85,3393000,-23,-649000,Multnomah County,Multnomah County-Bexar County-TX
2631,Multnomah County-Collin County-TX-1920,"Collin County, TX",1920,2019,2020,62,2656000,44,2395000,18,261000,Multnomah County,Multnomah County-Collin County-TX
2632,Multnomah County-Palm Beach County-FL-1920,"Palm Beach County, FL",1920,2019,2020,47,1522000,37,1749000,10,-227000,Multnomah County,Multnomah County-Palm Beach County-FL
2633,Multnomah County-Coos County-OR-1920,"Coos County, OR",1920,2019,2020,53,1822000,81,2998000,-28,-1176000,Multnomah County,Multnomah County-Coos County-OR
2634,Multnomah County-Coconino County-AZ-1920,"Coconino County, AZ",1920,2019,2020,42,1439000,31,1529000,11,-90000,Multnomah County,Multnomah County-Coconino County-AZ
2635,Multnomah County-Nevada County-CA-1920,"Nevada County, CA",1920,2019,2020,53,943000,36,1945000,17,-1002000,Multnomah County,Multnomah County-Nevada County-CA
2636,Multnomah County-Hawaii County-HI-1920,"Hawaii County, HI",1920,2019,2020,47,1887000,92,3084000,-45,-1197000,Multnomah County,Multnomah County-Hawaii County-HI
2637,Multnomah County-St. Louis County-MO-1920,"St. Louis County, MO",1920,2019,2020,56,2427000,36,1299000,20,1128000,Multnomah County,Multnomah County-St. Louis County-MO
2638,Multnomah County-Ramsey County-MN-1920,"Ramsey County, MN",1920,2019,2020,39,2027000,42,1867000,-3,160000,Multnomah County,Multnomah County-Ramsey County-MN
2639,Multnomah County-DuPage County-IL-1920,"DuPage County, IL",1920,2019,2020,44,2007000,27,1409000,17,598000,Multnomah County,Multnomah County-DuPage County-IL
2640,Multnomah County-Solano County-CA-1920,"Solano County, CA",1920,2019,2020,39,1531000,46,1900000,-7,-369000,Multnomah County,Multnomah County-Solano County-CA
2641,Multnomah County-St. Louis city-MO-1920,"St. Louis city, MO",1920,2019,2020,41,1984000,27,1236000,14,748000,Multnomah County,Multnomah County-St. Louis city-MO
2642,Multnomah County-Mecklenburg County-NC-1920,"Mecklenburg County, NC",1920,2019,2020,47,2503000,71,3095000,-24,-592000,Multnomah County,Multnomah County-Mecklenburg County-NC
2643,Multnomah County-Shelby County-TN-1920,"Shelby County, TN",1920,2019,2020,47,1866000,36,1145000,11,721000,Multnomah County,Multnomah County-Shelby County-TN
2644,Multnomah County-Klickitat County-WA-1920,"Klickitat County, WA",1920,2019,2020,41,1884000,134,10684000,-93,-8800000,Multnomah County,Multnomah County-Klickitat County-WA
2645,Multnomah County-Kern County-CA-1920,"Kern County, CA",1920,2019,2020,47,1102000,37,1002000,10,100000,Multnomah County,Multnomah County-Kern County-CA
2646,Multnomah County-Placer County-CA-1920,"Placer County, CA",1920,2019,2020,41,1721000,51,1710000,-10,11000,Multnomah County,Multnomah County-Placer County-CA
2647,Multnomah County-Monroe County-NY-1920,"Monroe County, NY",1920,2019,2020,37,1224000,43,2008000,-6,-784000,Multnomah County,Multnomah County-Monroe County-NY
2648,Multnomah County-Oklahoma County-OK-1920,"Oklahoma County, OK",1920,2019,2020,49,2337000,48,1649000,1,688000,Multnomah County,Multnomah County-Oklahoma County-OK
2649,Multnomah County-Duval County-FL-1920,"Duval County, FL",1920,2019,2020,38,1215000,34,1175000,4,40000,Multnomah County,Multnomah County-Duval County-FL
2650,Multnomah County-DeKalb County-GA-1920,"DeKalb County, GA",1920,2019,2020,51,1828000,44,1271000,7,557000,Multnomah County,Multnomah County-DeKalb County-GA
2651,Multnomah County-Shasta County-CA-1920,"Shasta County, CA",1920,2019,2020,39,1148000,27,846000,12,302000,Multnomah County,Multnomah County-Shasta County-CA
2652,Multnomah County-Erie County-NY-1920,"Erie County, NY",1920,2019,2020,31,1340000,29,1573000,2,-233000,Multnomah County,Multnomah County-Erie County-NY
2653,Multnomah County-Hamilton County-OH-1920,"Hamilton County, OH",1920,2019,2020,42,1851000,34,1501000,8,350000,Multnomah County,Multnomah County-Hamilton County-OH
2654,Multnomah County-Utah County-UT-1920,"Utah County, UT",1920,2019,2020,45,1456000,56,1469000,-11,-13000,Multnomah County,Multnomah County-Utah County-UT
2655,Multnomah County-Denton County-TX-1920,"Denton County, TX",1920,2019,2020,35,1369000,44,2728000,-9,-1359000,Multnomah County,Multnomah County-Denton County-TX
2656,Multnomah County-Lewis County-WA-1920,"Lewis County, WA",1920,2019,2020,35,1342000,44,1601000,-9,-259000,Multnomah County,Multnomah County-Lewis County-WA
2657,Multnomah County-Adams County-CO-1920,"Adams County, CO",1920,2019,2020,29,1250000,43,2417000,-14,-1167000,Multnomah County,Multnomah County-Adams County-CO
2658,Multnomah County-Cumberland County-ME-1920,"Cumberland County, ME",1920,2019,2020,35,2537000,55,3603000,-20,-1066000,Multnomah County,Multnomah County-Cumberland County-ME
2659,Multnomah County-Kent County-MI-1920,"Kent County, MI",1920,2019,2020,34,1252000,40,1625000,-6,-373000,Multnomah County,Multnomah County-Kent County-MI
2660,Multnomah County-Buncombe County-NC-1920,"Buncombe County, NC",1920,2019,2020,29,1586000,31,1270000,-2,316000,Multnomah County,Multnomah County-Buncombe County-NC
2661,Multnomah County-Santa Fe County-NM-1920,"Santa Fe County, NM",1920,2019,2020,32,1243000,58,2567000,-26,-1324000,Multnomah County,Multnomah County-Santa Fe County-NM
2662,Multnomah County-Canyon County-ID-1920,"Canyon County, ID",1920,2019,2020,35,903000,141,3239000,-106,-2336000,Multnomah County,Multnomah County-Canyon County-ID
2663,Multnomah County-Jefferson County-WA-1920,"Jefferson County, WA",1920,2019,2020,33,1196000,50,2551000,-17,-1355000,Multnomah County,Multnomah County-Jefferson County-WA
2664,Multnomah County-Flathead County-MT-1920,"Flathead County, MT",1920,2019,2020,38,760000,49,2847000,-11,-2087000,Multnomah County,Multnomah County-Flathead County-MT
2665,Multnomah County-Mohave County-AZ-1920,"Mohave County, AZ",1920,2019,2020,32,627000,40,1092000,-8,-465000,Multnomah County,Multnomah County-Mohave County-AZ
2666,Multnomah County-Wayne County-MI-1920,"Wayne County, MI",1920,2019,2020,24,1313000,47,1511000,-23,-198000,Multnomah County,Multnomah County-Wayne County-MI
2667,Multnomah County-Lee County-FL-1920,"Lee County, FL",1920,2019,2020,22,1058000,43,933000,-21,125000,Multnomah County,Multnomah County-Lee County-FL
2668,Multnomah County-Jefferson County-KY-1920,"Jefferson County, KY",1920,2019,2020,24,874000,31,1736000,-7,-862000,Multnomah County,Multnomah County-Jefferson County-KY
2669,Multnomah County-Jefferson County-OR-1920,"Jefferson County, OR",1920,2019,2020,32,973000,64,3577000,-32,-2604000,Multnomah County,Multnomah County-Jefferson County-OR
2670,Multnomah County-Walla Walla County-WA-1920,"Walla Walla County, WA",1920,2019,2020,24,1294000,42,1769000,-18,-475000,Multnomah County,Multnomah County-Walla Walla County-WA
2672,Polk County-Marion County-OR-1920,"Marion County, OR",1920,2019,2020,2831,76585000,2388,63718000,443,12867000,Polk County,Polk County-Marion County-OR
2673,Polk County-Yamhill County-OR-1920,"Yamhill County, OR",1920,2019,2020,587,12991000,352,8203000,235,4788000,Polk County,Polk County-Yamhill County-OR
2674,Polk County-Multnomah County-OR-1920,"Multnomah County, OR",1920,2019,2020,239,8940000,117,4293000,122,4647000,Polk County,Polk County-Multnomah County-OR
2675,Polk County-Washington County-OR-1920,"Washington County, OR",1920,2019,2020,278,8003000,211,6640000,67,1363000,Polk County,Polk County-Washington County-OR
2676,Polk County-Linn County-OR-1920,"Linn County, OR",1920,2019,2020,251,6456000,313,7682000,-62,-1226000,Polk County,Polk County-Linn County-OR
2677,Polk County-Benton County-OR-1920,"Benton County, OR",1920,2019,2020,191,5900000,179,4537000,12,1363000,Polk County,Polk County-Benton County-OR
2678,Polk County-Clackamas County-OR-1920,"Clackamas County, OR",1920,2019,2020,207,6385000,185,6261000,22,124000,Polk County,Polk County-Clackamas County-OR
2679,Polk County-Lane County-OR-1920,"Lane County, OR",1920,2019,2020,177,3740000,96,2965000,81,775000,Polk County,Polk County-Lane County-OR
2680,Polk County-Lincoln County-OR-1920,"Lincoln County, OR",1920,2019,2020,90,2552000,75,2390000,15,162000,Polk County,Polk County-Lincoln County-OR
2681,Polk County-Deschutes County-OR-1920,"Deschutes County, OR",1920,2019,2020,100,3073000,121,4843000,-21,-1770000,Polk County,Polk County-Deschutes County-OR
2682,Polk County-Clark County-WA-1920,"Clark County, WA",1920,2019,2020,53,1626000,64,1599000,-11,27000,Polk County,Polk County-Clark County-WA
2683,Polk County-Maricopa County-AZ-1920,"Maricopa County, AZ",1920,2019,2020,52,2123000,50,2149000,2,-26000,Polk County,Polk County-Maricopa County-AZ
2686,Tillamook County-Multnomah County-OR-1920,"Multnomah County, OR",1920,2019,2020,255,14922000,74,2001000,181,12921000,Tillamook County,Tillamook County-Multnomah County-OR
2687,Tillamook County-Washington County-OR-1920,"Washington County, OR",1920,2019,2020,207,8704000,122,6663000,85,2041000,Tillamook County,Tillamook County-Washington County-OR
2688,Tillamook County-Clackamas County-OR-1920,"Clackamas County, OR",1920,2019,2020,111,5384000,64,2021000,47,3363000,Tillamook County,Tillamook County-Clackamas County-OR
2689,Tillamook County-Lincoln County-OR-1920,"Lincoln County, OR",1920,2019,2020,56,2138000,48,1466000,8,672000,Tillamook County,Tillamook County-Lincoln County-OR
2690,Tillamook County-Clatsop County-OR-1920,"Clatsop County, OR",1920,2019,2020,61,1793000,45,1375000,16,418000,Tillamook County,Tillamook County-Clatsop County-OR
2691,Tillamook County-Marion County-OR-1920,"Marion County, OR",1920,2019,2020,59,2273000,68,1511000,-9,762000,Tillamook County,Tillamook County-Marion County-OR
2692,Tillamook County-Yamhill County-OR-1920,"Yamhill County, OR",1920,2019,2020,54,1349000,33,684000,21,665000,Tillamook County,Tillamook County-Yamhill County-OR
2693,Tillamook County-Clark County-WA-1920,"Clark County, WA",1920,2019,2020,38,1572000,36,1474000,2,98000,Tillamook County,Tillamook County-Clark County-WA
2695,Umatilla County-Morrow County-OR-1920,"Morrow County, OR",1920,2019,2020,306,6732000,322,6940000,-16,-208000,Umatilla County,Umatilla County-Morrow County-OR
2696,Umatilla County-Walla Walla County-WA-1920,"Walla Walla County, WA",1920,2019,2020,298,6696000,323,7939000,-25,-1243000,Umatilla County,Umatilla County-Walla Walla County-WA
2697,Umatilla County-Benton County-WA-1920,"Benton County, WA",1920,2019,2020,195,5539000,285,9391000,-90,-3852000,Umatilla County,Umatilla County-Benton County-WA
2698,Umatilla County-Union County-OR-1920,"Union County, OR",1920,2019,2020,103,2601000,99,1995000,4,606000,Umatilla County,Umatilla County-Union County-OR
2699,Umatilla County-Multnomah County-OR-1920,"Multnomah County, OR",1920,2019,2020,81,2590000,67,1770000,14,820000,Umatilla County,Umatilla County-Multnomah County-OR
2700,Umatilla County-Washington County-OR-1920,"Washington County, OR",1920,2019,2020,58,1345000,44,1350000,14,-5000,Umatilla County,Umatilla County-Washington County-OR
2701,Umatilla County-Franklin County-WA-1920,"Franklin County, WA",1920,2019,2020,72,1281000,90,2061000,-18,-780000,Umatilla County,Umatilla County-Franklin County-WA
2702,Umatilla County-Marion County-OR-1920,"Marion County, OR",1920,2019,2020,67,1503000,55,1135000,12,368000,Umatilla County,Umatilla County-Marion County-OR
2703,Umatilla County-Deschutes County-OR-1920,"Deschutes County, OR",1920,2019,2020,47,1068000,50,2464000,-3,-1396000,Umatilla County,Umatilla County-Deschutes County-OR
2704,Umatilla County-Clackamas County-OR-1920,"Clackamas County, OR",1920,2019,2020,67,1372000,50,1249000,17,123000,Umatilla County,Umatilla County-Clackamas County-OR
2705,Umatilla County-Spokane County-WA-1920,"Spokane County, WA",1920,2019,2020,33,738000,56,1187000,-23,-449000,Umatilla County,Umatilla County-Spokane County-WA
2707,Union County-Umatilla County-OR-1920,"Umatilla County, OR",1920,2019,2020,99,1995000,103,2601000,-4,-606000,Union County,Union County-Umatilla County-OR
2708,Union County-Baker County-OR-1920,"Baker County, OR",1920,2019,2020,75,1620000,81,1953000,-6,-333000,Union County,Union County-Baker County-OR
2709,Union County-Ada County-ID-1920,"Ada County, ID",1920,2019,2020,46,1292000,58,1384000,-12,-92000,Union County,Union County-Ada County-ID
2712,Wasco County-Hood River County-OR-1920,"Hood River County, OR",1920,2019,2020,269,7360000,144,4389000,125,2971000,Wasco County,Wasco County-Hood River County-OR
2713,Wasco County-Multnomah County-OR-1920,"Multnomah County, OR",1920,2019,2020,122,6393000,89,2267000,33,4126000,Wasco County,Wasco County-Multnomah County-OR
2714,Wasco County-Klickitat County-WA-1920,"Klickitat County, WA",1920,2019,2020,116,2900000,139,3438000,-23,-538000,Wasco County,Wasco County-Klickitat County-WA
2715,Wasco County-Clackamas County-OR-1920,"Clackamas County, OR",1920,2019,2020,70,3495000,74,1740000,-4,1755000,Wasco County,Wasco County-Clackamas County-OR
2716,Wasco County-Washington County-OR-1920,"Washington County, OR",1920,2019,2020,56,1064000,48,1694000,8,-630000,Wasco County,Wasco County-Washington County-OR
2717,Wasco County-Clark County-WA-1920,"Clark County, WA",1920,2019,2020,38,1002000,47,1690000,-9,-688000,Wasco County,Wasco County-Clark County-WA
2719,Washington County-Multnomah County-OR-1920,"Multnomah County, OR",1920,2019,2020,7922,377836000,6445,329865000,1477,47971000,Washington County,Washington County-Multnomah County-OR
2720,Washington County-Clackamas County-OR-1920,"Clackamas County, OR",1920,2019,2020,3385,142290000,4181,230095000,-796,-87805000,Washington County,Washington County-Clackamas County-OR
2721,Washington County-Clark County-WA-1920,"Clark County, WA",1920,2019,2020,1171,38871000,2056,98918000,-885,-60047000,Washington County,Washington County-Clark County-WA
2722,Washington County-Yamhill County-OR-1920,"Yamhill County, OR",1920,2019,2020,1026,35557000,1947,70722000,-921,-35165000,Washington County,Washington County-Yamhill County-OR
2723,Washington County-Marion County-OR-1920,"Marion County, OR",1920,2019,2020,965,28031000,1510,42169000,-545,-14138000,Washington County,Washington County-Marion County-OR
2724,Washington County-Los Angeles County-CA-1920,"Los Angeles County, CA",1920,2019,2020,931,40051000,382,16168000,549,23883000,Washington County,Washington County-Los Angeles County-CA
2725,Washington County-King County-WA-1920,"King County, WA",1920,2019,2020,613,37668000,764,65263000,-151,-27595000,Washington County,Washington County-King County-WA
2726,Washington County-Maricopa County-AZ-1920,"Maricopa County, AZ",1920,2019,2020,607,27828000,959,53728000,-352,-25900000,Washington County,Washington County-Maricopa County-AZ
2727,Washington County-Lane County-OR-1920,"Lane County, OR",1920,2019,2020,498,16876000,397,14462000,101,2414000,Washington County,Washington County-Lane County-OR
2728,Washington County-Santa Clara County-CA-1920,"Santa Clara County, CA",1920,2019,2020,532,37464000,334,39060000,198,-1596000,Washington County,Washington County-Santa Clara County-CA
2729,Washington County-San Diego County-CA-1920,"San Diego County, CA",1920,2019,2020,441,18762000,302,15919000,139,2843000,Washington County,Washington County-San Diego County-CA
2730,Washington County-Columbia County-OR-1920,"Columbia County, OR",1920,2019,2020,427,12996000,887,30005000,-460,-17009000,Washington County,Washington County-Columbia County-OR
2731,Washington County-Benton County-OR-1920,"Benton County, OR",1920,2019,2020,305,10082000,160,6304000,145,3778000,Washington County,Washington County-Benton County-OR
2732,Washington County-Orange County-CA-1920,"Orange County, CA",1920,2019,2020,355,15630000,238,11815000,117,3815000,Washington County,Washington County-Orange County-CA
2733,Washington County-Deschutes County-OR-1920,"Deschutes County, OR",1920,2019,2020,325,11853000,732,38625000,-407,-26772000,Washington County,Washington County-Deschutes County-OR
2734,Washington County-Alameda County-CA-1920,"Alameda County, CA",1920,2019,2020,324,20175000,150,8663000,174,11512000,Washington County,Washington County-Alameda County-CA
2735,Washington County-Honolulu County-HI-1920,"Honolulu County, HI",1920,2019,2020,242,8900000,134,4814000,108,4086000,Washington County,Washington County-Honolulu County-HI
2736,Washington County-Jackson County-OR-1920,"Jackson County, OR",1920,2019,2020,241,6158000,227,7950000,14,-1792000,Washington County,Washington County-Jackson County-OR
2737,Washington County-Polk County-OR-1920,"Polk County, OR",1920,2019,2020,211,6640000,278,8003000,-67,-1363000,Washington County,Washington County-Polk County-OR
2738,Washington County-Clark County-NV-1920,"Clark County, NV",1920,2019,2020,235,6869000,283,17204000,-48,-10335000,Washington County,Washington County-Clark County-NV
2739,Washington County-Snohomish County-WA-1920,"Snohomish County, WA",1920,2019,2020,206,8218000,172,10407000,34,-2189000,Washington County,Washington County-Snohomish County-WA
2740,Washington County-Pierce County-WA-1920,"Pierce County, WA",1920,2019,2020,196,6002000,206,6991000,-10,-989000,Washington County,Washington County-Pierce County-WA
2741,Washington County-Riverside County-CA-1920,"Riverside County, CA",1920,2019,2020,213,5847000,206,7661000,7,-1814000,Washington County,Washington County-Riverside County-CA
2742,Washington County-Linn County-OR-1920,"Linn County, OR",1920,2019,2020,166,4012000,203,5516000,-37,-1504000,Washington County,Washington County-Linn County-OR
2743,Washington County-San Francisco County-CA-1920,"San Francisco County, CA",1920,2019,2020,152,12862000,59,3402000,93,9460000,Washington County,Washington County-San Francisco County-CA
2744,Washington County-Salt Lake County-UT-1920,"Salt Lake County, UT",1920,2019,2020,172,5833000,119,5394000,53,439000,Washington County,Washington County-Salt Lake County-UT
2745,Washington County-Contra Costa County-CA-1920,"Contra Costa County, CA",1920,2019,2020,149,8761000,99,5016000,50,3745000,Washington County,Washington County-Contra Costa County-CA
2746,Washington County-Cook County-IL-1920,"Cook County, IL",1920,2019,2020,135,8379000,91,3412000,44,4967000,Washington County,Washington County-Cook County-IL
2747,Washington County-Sacramento County-CA-1920,"Sacramento County, CA",1920,2019,2020,138,5178000,154,6112000,-16,-934000,Washington County,Washington County-Sacramento County-CA
2748,Washington County-San Bernardino County-CA-1920,"San Bernardino County, CA",1920,2019,2020,152,3273000,56,1726000,96,1547000,Washington County,Washington County-San Bernardino County-CA
2749,Washington County-Clatsop County-OR-1920,"Clatsop County, OR",1920,2019,2020,138,4779000,231,12079000,-93,-7300000,Washington County,Washington County-Clatsop County-OR
2750,Washington County-Tillamook County-OR-1920,"Tillamook County, OR",1920,2019,2020,122,6663000,207,8704000,-85,-2041000,Washington County,Washington County-Tillamook County-OR
2751,Washington County-Harris County-TX-1920,"Harris County, TX",1920,2019,2020,151,7819000,111,4018000,40,3801000,Washington County,Washington County-Harris County-TX
2752,Washington County-San Mateo County-CA-1920,"San Mateo County, CA",1920,2019,2020,130,10396000,72,4743000,58,5653000,Washington County,Washington County-San Mateo County-CA
2753,Washington County-Travis County-TX-1920,"Travis County, TX",1920,2019,2020,133,7958000,205,14211000,-72,-6253000,Washington County,Washington County-Travis County-TX
2754,Washington County-Lincoln County-OR-1920,"Lincoln County, OR",1920,2019,2020,120,3714000,156,9939000,-36,-6225000,Washington County,Washington County-Lincoln County-OR
2755,Washington County-Ventura County-CA-1920,"Ventura County, CA",1920,2019,2020,107,4363000,39,1610000,68,2753000,Washington County,Washington County-Ventura County-CA
2756,Washington County-Ada County-ID-1920,"Ada County, ID",1920,2019,2020,110,3609000,299,13199000,-189,-9590000,Washington County,Washington County-Ada County-ID
2757,Washington County-Utah County-UT-1920,"Utah County, UT",1920,2019,2020,132,3060000,203,5745000,-71,-2685000,Washington County,Washington County-Utah County-UT
2758,Washington County-Spokane County-WA-1920,"Spokane County, WA",1920,2019,2020,85,2269000,200,7871000,-115,-5602000,Washington County,Washington County-Spokane County-WA
2759,Washington County-Hennepin County-MN-1920,"Hennepin County, MN",1920,2019,2020,78,4075000,44,2679000,34,1396000,Washington County,Washington County-Hennepin County-MN
2760,Washington County-Dallas County-TX-1920,"Dallas County, TX",1920,2019,2020,93,4242000,114,5532000,-21,-1290000,Washington County,Washington County-Dallas County-TX
2761,Washington County-Pima County-AZ-1920,"Pima County, AZ",1920,2019,2020,83,2740000,117,4468000,-34,-1728000,Washington County,Washington County-Pima County-AZ
2762,Washington County-Thurston County-WA-1920,"Thurston County, WA",1920,2019,2020,69,2268000,86,4436000,-17,-2168000,Washington County,Washington County-Thurston County-WA
2763,Washington County-Cowlitz County-WA-1920,"Cowlitz County, WA",1920,2019,2020,86,2097000,166,6081000,-80,-3984000,Washington County,Washington County-Cowlitz County-WA
2764,Washington County-Benton County-WA-1920,"Benton County, WA",1920,2019,2020,71,3298000,81,3152000,-10,146000,Washington County,Washington County-Benton County-WA
2765,Washington County-Washoe County-NV-1920,"Washoe County, NV",1920,2019,2020,78,3147000,89,3153000,-11,-6000,Washington County,Washington County-Washoe County-NV
2766,Washington County-Denver County-CO-1920,"Denver County, CO",1920,2019,2020,59,2815000,41,1614000,18,1201000,Washington County,Washington County-Denver County-CO
2767,Washington County-Kings County-NY-1920,"Kings County, NY",1920,2019,2020,58,2813000,30,1232000,28,1581000,Washington County,Washington County-Kings County-NY
2768,Washington County-New York County-NY-1920,"New York County, NY",1920,2019,2020,55,4869000,40,2110000,15,2759000,Washington County,Washington County-New York County-NY
2769,Washington County-Douglas County-OR-1920,"Douglas County, OR",1920,2019,2020,67,1779000,133,4293000,-66,-2514000,Washington County,Washington County-Douglas County-OR
2770,Washington County-Sonoma County-CA-1920,"Sonoma County, CA",1920,2019,2020,71,3079000,30,1225000,41,1854000,Washington County,Washington County-Sonoma County-CA
2771,Washington County-Anchorage Municipality-AK-1920,"Anchorage Municipality, AK",1920,2019,2020,62,2578000,35,1089000,27,1489000,Washington County,Washington County-Anchorage Municipality-AK
2772,Washington County-Middlesex County-MA-1920,"Middlesex County, MA",1920,2019,2020,63,5191000,59,2950000,4,2241000,Washington County,Washington County-Middlesex County-MA
2773,Washington County-Kitsap County-WA-1920,"Kitsap County, WA",1920,2019,2020,59,2318000,70,2885000,-11,-567000,Washington County,Washington County-Kitsap County-WA
2774,Washington County-Josephine County-OR-1920,"Josephine County, OR",1920,2019,2020,56,1619000,72,1988000,-16,-369000,Washington County,Washington County-Josephine County-OR
2775,Washington County-Tarrant County-TX-1920,"Tarrant County, TX",1920,2019,2020,70,2867000,70,4045000,0,-1178000,Washington County,Washington County-Tarrant County-TX
2776,Washington County-Placer County-CA-1920,"Placer County, CA",1920,2019,2020,59,2325000,51,2134000,8,191000,Washington County,Washington County-Placer County-CA
2777,Washington County-Arapahoe County-CO-1920,"Arapahoe County, CO",1920,2019,2020,56,1937000,58,3131000,-2,-1194000,Washington County,Washington County-Arapahoe County-CO
2778,Washington County-Bexar County-TX-1920,"Bexar County, TX",1920,2019,2020,73,2385000,70,4131000,3,-1746000,Washington County,Washington County-Bexar County-TX
2779,Washington County-Fairfax County-VA-1920,"Fairfax County, VA",1920,2019,2020,72,3254000,75,3293000,-3,-39000,Washington County,Washington County-Fairfax County-VA
2780,Washington County-Franklin County-OH-1920,"Franklin County, OH",1920,2019,2020,53,1906000,62,1336000,-9,570000,Washington County,Washington County-Franklin County-OH
2781,Washington County-Maui County-HI-1920,"Maui County, HI",1920,2019,2020,62,1629000,32,1485000,30,144000,Washington County,Washington County-Maui County-HI
2782,Washington County-Klamath County-OR-1920,"Klamath County, OR",1920,2019,2020,42,1153000,90,2659000,-48,-1506000,Washington County,Washington County-Klamath County-OR
2783,Washington County-Collin County-TX-1920,"Collin County, TX",1920,2019,2020,78,2844000,170,6901000,-92,-4057000,Washington County,Washington County-Collin County-TX
2784,Washington County-Hawaii County-HI-1920,"Hawaii County, HI",1920,2019,2020,64,1298000,33,1176000,31,122000,Washington County,Washington County-Hawaii County-HI
2785,Washington County-Yakima County-WA-1920,"Yakima County, WA",1920,2019,2020,59,1557000,52,1480000,7,77000,Washington County,Washington County-Yakima County-WA
2786,Washington County-San Joaquin County-CA-1920,"San Joaquin County, CA",1920,2019,2020,78,2044000,30,1168000,48,876000,Washington County,Washington County-San Joaquin County-CA
2787,Washington County-Larimer County-CO-1920,"Larimer County, CO",1920,2019,2020,52,1848000,32,1769000,20,79000,Washington County,Washington County-Larimer County-CO
2788,Washington County-Orange County-FL-1920,"Orange County, FL",1920,2019,2020,52,1535000,46,1871000,6,-336000,Washington County,Washington County-Orange County-FL
2789,Washington County-Bernalillo County-NM-1920,"Bernalillo County, NM",1920,2019,2020,52,2580000,73,3041000,-21,-461000,Washington County,Washington County-Bernalillo County-NM
2790,Washington County-Wasco County-OR-1920,"Wasco County, OR",1920,2019,2020,48,1694000,56,1064000,-8,630000,Washington County,Washington County-Wasco County-OR
2791,Washington County-El Paso County-CO-1920,"El Paso County, CO",1920,2019,2020,53,1471000,66,3648000,-13,-2177000,Washington County,Washington County-El Paso County-CO
2792,Washington County-Hood River County-OR-1920,"Hood River County, OR",1920,2019,2020,43,1569000,60,2404000,-17,-835000,Washington County,Washington County-Hood River County-OR
2793,Washington County-Umatilla County-OR-1920,"Umatilla County, OR",1920,2019,2020,44,1350000,58,1345000,-14,5000,Washington County,Washington County-Umatilla County-OR
2794,Washington County-Hillsborough County-FL-1920,"Hillsborough County, FL",1920,2019,2020,64,1702000,44,2059000,20,-357000,Washington County,Washington County-Hillsborough County-FL
2795,Washington County-Mecklenburg County-NC-1920,"Mecklenburg County, NC",1920,2019,2020,46,1639000,38,1333000,8,306000,Washington County,Washington County-Mecklenburg County-NC
2796,Washington County-Monterey County-CA-1920,"Monterey County, CA",1920,2019,2020,47,1482000,35,1308000,12,174000,Washington County,Washington County-Monterey County-CA
2797,Washington County-Wake County-NC-1920,"Wake County, NC",1920,2019,2020,44,1343000,49,3279000,-5,-1936000,Washington County,Washington County-Wake County-NC
2798,Washington County-Coos County-OR-1920,"Coos County, OR",1920,2019,2020,39,1521000,61,1587000,-22,-66000,Washington County,Washington County-Coos County-OR
2799,Washington County-Davidson County-TN-1920,"Davidson County, TN",1920,2019,2020,39,1345000,33,1713000,6,-368000,Washington County,Washington County-Davidson County-TN
2800,Washington County-Whatcom County-WA-1920,"Whatcom County, WA",1920,2019,2020,33,1039000,66,3411000,-33,-2372000,Washington County,Washington County-Whatcom County-WA
2801,Washington County-Oakland County-MI-1920,"Oakland County, MI",1920,2019,2020,69,1655000,44,2337000,25,-682000,Washington County,Washington County-Oakland County-MI
2802,Washington County-Pinal County-AZ-1920,"Pinal County, AZ",1920,2019,2020,39,952000,147,6225000,-108,-5273000,Washington County,Washington County-Pinal County-AZ
2803,Washington County-Pinellas County-FL-1920,"Pinellas County, FL",1920,2019,2020,29,1137000,40,2146000,-11,-1009000,Washington County,Washington County-Pinellas County-FL
2804,Washington County-Allegheny County-PA-1920,"Allegheny County, PA",1920,2019,2020,37,1741000,42,1958000,-5,-217000,Washington County,Washington County-Allegheny County-PA
2805,Washington County-Denton County-TX-1920,"Denton County, TX",1920,2019,2020,41,1580000,50,2703000,-9,-1123000,Washington County,Washington County-Denton County-TX
2806,Washington County-Williamson County-TX-1920,"Williamson County, TX",1920,2019,2020,66,1574000,103,7393000,-37,-5819000,Washington County,Washington County-Williamson County-TX
2809,Yamhill County-Washington County-OR-1920,"Washington County, OR",1920,2019,2020,1947,70722000,1026,35557000,921,35165000,Yamhill County,Yamhill County-Washington County-OR
2810,Yamhill County-Multnomah County-OR-1920,"Multnomah County, OR",1920,2019,2020,465,27297000,289,8325000,176,18972000,Yamhill County,Yamhill County-Multnomah County-OR
2811,Yamhill County-Clackamas County-OR-1920,"Clackamas County, OR",1920,2019,2020,473,17619000,343,11920000,130,5699000,Yamhill County,Yamhill County-Clackamas County-OR
2812,Yamhill County-Marion County-OR-1920,"Marion County, OR",1920,2019,2020,433,11202000,478,11416000,-45,-214000,Yamhill County,Yamhill County-Marion County-OR
2813,Yamhill County-Polk County-OR-1920,"Polk County, OR",1920,2019,2020,352,8203000,587,12991000,-235,-4788000,Yamhill County,Yamhill County-Polk County-OR
2814,Yamhill County-Lane County-OR-1920,"Lane County, OR",1920,2019,2020,69,2244000,94,2986000,-25,-742000,Yamhill County,Yamhill County-Lane County-OR
2815,Yamhill County-Deschutes County-OR-1920,"Deschutes County, OR",1920,2019,2020,77,1949000,162,8602000,-85,-6653000,Yamhill County,Yamhill County-Deschutes County-OR
2816,Yamhill County-Clark County-WA-1920,"Clark County, WA",1920,2019,2020,89,3423000,149,4476000,-60,-1053000,Yamhill County,Yamhill County-Clark County-WA
2817,Yamhill County-Lincoln County-OR-1920,"Lincoln County, OR",1920,2019,2020,82,3326000,59,2201000,23,1125000,Yamhill County,Yamhill County-Lincoln County-OR
2818,Yamhill County-King County-WA-1920,"King County, WA",1920,2019,2020,63,4676000,38,1482000,25,3194000,Yamhill County,Yamhill County-King County-WA
2819,Yamhill County-Benton County-OR-1920,"Benton County, OR",1920,2019,2020,46,1475000,38,851000,8,624000,Yamhill County,Yamhill County-Benton County-OR
2820,Yamhill County-Linn County-OR-1920,"Linn County, OR",1920,2019,2020,62,1802000,75,1665000,-13,137000,Yamhill County,Yamhill County-Linn County-OR
2821,Yamhill County-Jackson County-OR-1920,"Jackson County, OR",1920,2019,2020,30,1204000,37,1319000,-7,-115000,Yamhill County,Yamhill County-Jackson County-OR
2822,Yamhill County-Maricopa County-AZ-1920,"Maricopa County, AZ",1920,2019,2020,38,1757000,61,3869000,-23,-2112000,Yamhill County,Yamhill County-Maricopa County-AZ
2823,Yamhill County-Tillamook County-OR-1920,"Tillamook County, OR",1920,2019,2020,33,684000,54,1349000,-21,-665000,Yamhill County,Yamhill County-Tillamook County-OR
2825,Baker County-Union County-OR-2021,"Union County, OR",2021,2020,2021,79,1775000,110,2389000,-31,-614000,Baker County,Baker County-Union County-OR
2826,Baker County-Ada County-ID-2021,"Ada County, ID",2021,2020,2021,42,1506000,60,1139000,-18,367000,Baker County,Baker County-Ada County-ID
2828,Benton County-Linn County-OR-2021,"Linn County, OR",2021,2020,2021,1249,35227000,1275,38339000,-26,-3112000,Benton County,Benton County-Linn County-OR
2829,Benton County-Lane County-OR-2021,"Lane County, OR",2021,2020,2021,391,10895000,354,11676000,37,-781000,Benton County,Benton County-Lane County-OR
2830,Benton County-Multnomah County-OR-2021,"Multnomah County, OR",2021,2020,2021,276,12716000,314,10150000,-38,2566000,Benton County,Benton County-Multnomah County-OR
2831,Benton County-Marion County-OR-2021,"Marion County, OR",2021,2020,2021,351,8829000,286,9635000,65,-806000,Benton County,Benton County-Marion County-OR
2832,Benton County-Washington County-OR-2021,"Washington County, OR",2021,2020,2021,214,7268000,284,10313000,-70,-3045000,Benton County,Benton County-Washington County-OR
2833,Benton County-Lincoln County-OR-2021,"Lincoln County, OR",2021,2020,2021,181,4733000,122,3659000,59,1074000,Benton County,Benton County-Lincoln County-OR
2834,Benton County-Clackamas County-OR-2021,"Clackamas County, OR",2021,2020,2021,158,4108000,184,5821000,-26,-1713000,Benton County,Benton County-Clackamas County-OR
2835,Benton County-Polk County-OR-2021,"Polk County, OR",2021,2020,2021,162,5559000,204,6792000,-42,-1233000,Benton County,Benton County-Polk County-OR
2836,Benton County-Jackson County-OR-2021,"Jackson County, OR",2021,2020,2021,99,2808000,82,2358000,17,450000,Benton County,Benton County-Jackson County-OR
2837,Benton County-Los Angeles County-CA-2021,"Los Angeles County, CA",2021,2020,2021,85,4474000,41,1339000,44,3135000,Benton County,Benton County-Los Angeles County-CA
2838,Benton County-Deschutes County-OR-2021,"Deschutes County, OR",2021,2020,2021,91,3193000,166,6190000,-75,-2997000,Benton County,Benton County-Deschutes County-OR
2839,Benton County-Yamhill County-OR-2021,"Yamhill County, OR",2021,2020,2021,85,2313000,52,2060000,33,253000,Benton County,Benton County-Yamhill County-OR
2840,Benton County-King County-WA-2021,"King County, WA",2021,2020,2021,78,3437000,100,4279000,-22,-842000,Benton County,Benton County-King County-WA
2841,Benton County-San Diego County-CA-2021,"San Diego County, CA",2021,2020,2021,65,2321000,49,2422000,16,-101000,Benton County,Benton County-San Diego County-CA
2842,Benton County-Douglas County-OR-2021,"Douglas County, OR",2021,2020,2021,49,1221000,59,1402000,-10,-181000,Benton County,Benton County-Douglas County-OR
2843,Benton County-Maricopa County-AZ-2021,"Maricopa County, AZ",2021,2020,2021,60,1591000,65,2380000,-5,-789000,Benton County,Benton County-Maricopa County-AZ
2844,Benton County-Ada County-ID-2021,"Ada County, ID",2021,2020,2021,56,1660000,51,1898000,5,-238000,Benton County,Benton County-Ada County-ID
2845,Benton County-Clark County-WA-2021,"Clark County, WA",2021,2020,2021,43,1505000,87,3647000,-44,-2142000,Benton County,Benton County-Clark County-WA
2847,Clackamas County-Multnomah County-OR-2021,"Multnomah County, OR",2021,2020,2021,10819,583414000,6068,222634000,4751,360780000,Clackamas County,Clackamas County-Multnomah County-OR
2848,Clackamas County-Washington County-OR-2021,"Washington County, OR",2021,2020,2021,3714,252516000,3327,140925000,387,111591000,Clackamas County,Clackamas County-Washington County-OR
2849,Clackamas County-Marion County-OR-2021,"Marion County, OR",2021,2020,2021,1307,42037000,1738,60459000,-431,-18422000,Clackamas County,Clackamas County-Marion County-OR
2850,Clackamas County-Clark County-WA-2021,"Clark County, WA",2021,2020,2021,903,32913000,1733,98872000,-830,-65959000,Clackamas County,Clackamas County-Clark County-WA
2851,Clackamas County-Los Angeles County-CA-2021,"Los Angeles County, CA",2021,2020,2021,495,27921000,180,9595000,315,18326000,Clackamas County,Clackamas County-Los Angeles County-CA
2852,Clackamas County-King County-WA-2021,"King County, WA",2021,2020,2021,364,28687000,260,20600000,104,8087000,Clackamas County,Clackamas County-King County-WA
2853,Clackamas County-Lane County-OR-2021,"Lane County, OR",2021,2020,2021,303,12018000,323,12728000,-20,-710000,Clackamas County,Clackamas County-Lane County-OR
2854,Clackamas County-Yamhill County-OR-2021,"Yamhill County, OR",2021,2020,2021,346,14826000,555,29543000,-209,-14717000,Clackamas County,Clackamas County-Yamhill County-OR
2855,Clackamas County-Deschutes County-OR-2021,"Deschutes County, OR",2021,2020,2021,304,14814000,705,64676000,-401,-49862000,Clackamas County,Clackamas County-Deschutes County-OR
2856,Clackamas County-Maricopa County-AZ-2021,"Maricopa County, AZ",2021,2020,2021,303,12776000,652,45196000,-349,-32420000,Clackamas County,Clackamas County-Maricopa County-AZ
2857,Clackamas County-Santa Clara County-CA-2021,"Santa Clara County, CA",2021,2020,2021,326,53242000,49,2394000,277,50848000,Clackamas County,Clackamas County-Santa Clara County-CA
2858,Clackamas County-San Diego County-CA-2021,"San Diego County, CA",2021,2020,2021,218,10881000,155,6312000,63,4569000,Clackamas County,Clackamas County-San Diego County-CA
2859,Clackamas County-Benton County-OR-2021,"Benton County, OR",2021,2020,2021,184,5821000,158,4108000,26,1713000,Clackamas County,Clackamas County-Benton County-OR
2860,Clackamas County-Orange County-CA-2021,"Orange County, CA",2021,2020,2021,186,9567000,146,11502000,40,-1935000,Clackamas County,Clackamas County-Orange County-CA
2861,Clackamas County-Columbia County-OR-2021,"Columbia County, OR",2021,2020,2021,179,5600000,212,7341000,-33,-1741000,Clackamas County,Clackamas County-Columbia County-OR
2862,Clackamas County-Polk County-OR-2021,"Polk County, OR",2021,2020,2021,159,5025000,207,6977000,-48,-1952000,Clackamas County,Clackamas County-Polk County-OR
2863,Clackamas County-Jackson County-OR-2021,"Jackson County, OR",2021,2020,2021,131,5364000,165,6061000,-34,-697000,Clackamas County,Clackamas County-Jackson County-OR
2864,Clackamas County-Alameda County-CA-2021,"Alameda County, CA",2021,2020,2021,180,13251000,43,3859000,137,9392000,Clackamas County,Clackamas County-Alameda County-CA
2865,Clackamas County-Linn County-OR-2021,"Linn County, OR",2021,2020,2021,135,4139000,164,6157000,-29,-2018000,Clackamas County,Clackamas County-Linn County-OR
2866,Clackamas County-Clark County-NV-2021,"Clark County, NV",2021,2020,2021,120,5628000,189,15406000,-69,-9778000,Clackamas County,Clackamas County-Clark County-NV
2867,Clackamas County-Riverside County-CA-2021,"Riverside County, CA",2021,2020,2021,138,4497000,103,10206000,35,-5709000,Clackamas County,Clackamas County-Riverside County-CA
2868,Clackamas County-Lincoln County-OR-2021,"Lincoln County, OR",2021,2020,2021,112,4540000,145,5791000,-33,-1251000,Clackamas County,Clackamas County-Lincoln County-OR
2869,Clackamas County-Pierce County-WA-2021,"Pierce County, WA",2021,2020,2021,128,6217000,142,7173000,-14,-956000,Clackamas County,Clackamas County-Pierce County-WA
2870,Clackamas County-San Francisco County-CA-2021,"San Francisco County, CA",2021,2020,2021,92,13077000,36,3079000,56,9998000,Clackamas County,Clackamas County-San Francisco County-CA
2871,Clackamas County-Clatsop County-OR-2021,"Clatsop County, OR",2021,2020,2021,93,3495000,159,10454000,-66,-6959000,Clackamas County,Clackamas County-Clatsop County-OR
2872,Clackamas County-Douglas County-OR-2021,"Douglas County, OR",2021,2020,2021,78,2244000,104,4255000,-26,-2011000,Clackamas County,Clackamas County-Douglas County-OR
2873,Clackamas County-Sacramento County-CA-2021,"Sacramento County, CA",2021,2020,2021,81,2915000,41,1589000,40,1326000,Clackamas County,Clackamas County-Sacramento County-CA
2874,Clackamas County-Spokane County-WA-2021,"Spokane County, WA",2021,2020,2021,76,2335000,109,5449000,-33,-3114000,Clackamas County,Clackamas County-Spokane County-WA
2875,Clackamas County-Snohomish County-WA-2021,"Snohomish County, WA",2021,2020,2021,79,2869000,79,2664000,0,205000,Clackamas County,Clackamas County-Snohomish County-WA
2876,Clackamas County-Ada County-ID-2021,"Ada County, ID",2021,2020,2021,69,2683000,268,13609000,-199,-10926000,Clackamas County,Clackamas County-Ada County-ID
2877,Clackamas County-Honolulu County-HI-2021,"Honolulu County, HI",2021,2020,2021,78,2589000,74,3791000,4,-1202000,Clackamas County,Clackamas County-Honolulu County-HI
2878,Clackamas County-Pima County-AZ-2021,"Pima County, AZ",2021,2020,2021,67,2353000,105,4651000,-38,-2298000,Clackamas County,Clackamas County-Pima County-AZ
2879,Clackamas County-Wasco County-OR-2021,"Wasco County, OR",2021,2020,2021,73,1828000,70,1516000,3,312000,Clackamas County,Clackamas County-Wasco County-OR
2880,Clackamas County-Cowlitz County-WA-2021,"Cowlitz County, WA",2021,2020,2021,67,3332000,142,5727000,-75,-2395000,Clackamas County,Clackamas County-Cowlitz County-WA
2881,Clackamas County-San Bernardino County-CA-2021,"San Bernardino County, CA",2021,2020,2021,61,2548000,57,2934000,4,-386000,Clackamas County,Clackamas County-San Bernardino County-CA
2882,Clackamas County-Klamath County-OR-2021,"Klamath County, OR",2021,2020,2021,48,2133000,75,2700000,-27,-567000,Clackamas County,Clackamas County-Klamath County-OR
2883,Clackamas County-Tillamook County-OR-2021,"Tillamook County, OR",2021,2020,2021,47,1994000,84,8696000,-37,-6702000,Clackamas County,Clackamas County-Tillamook County-OR
2884,Clackamas County-Coos County-OR-2021,"Coos County, OR",2021,2020,2021,45,1891000,47,1809000,-2,82000,Clackamas County,Clackamas County-Coos County-OR
2885,Clackamas County-Salt Lake County-UT-2021,"Salt Lake County, UT",2021,2020,2021,45,1781000,77,2871000,-32,-1090000,Clackamas County,Clackamas County-Salt Lake County-UT
2886,Clackamas County-Washoe County-NV-2021,"Washoe County, NV",2021,2020,2021,45,2771000,36,1970000,9,801000,Clackamas County,Clackamas County-Washoe County-NV
2887,Clackamas County-Jefferson County-OR-2021,"Jefferson County, OR",2021,2020,2021,41,1021000,121,5503000,-80,-4482000,Clackamas County,Clackamas County-Jefferson County-OR
2888,Clackamas County-Hood River County-OR-2021,"Hood River County, OR",2021,2020,2021,37,1324000,33,3083000,4,-1759000,Clackamas County,Clackamas County-Hood River County-OR
2889,Clackamas County-Josephine County-OR-2021,"Josephine County, OR",2021,2020,2021,42,1273000,38,1348000,4,-75000,Clackamas County,Clackamas County-Josephine County-OR
2890,Clackamas County-Denver County-CO-2021,"Denver County, CO",2021,2020,2021,42,2415000,36,1674000,6,741000,Clackamas County,Clackamas County-Denver County-CO
2891,Clackamas County-Harris County-TX-2021,"Harris County, TX",2021,2020,2021,54,4364000,77,3081000,-23,1283000,Clackamas County,Clackamas County-Harris County-TX
2892,Clackamas County-Travis County-TX-2021,"Travis County, TX",2021,2020,2021,35,2398000,51,2658000,-16,-260000,Clackamas County,Clackamas County-Travis County-TX
2893,Clackamas County-Thurston County-WA-2021,"Thurston County, WA",2021,2020,2021,51,2186000,60,2475000,-9,-289000,Clackamas County,Clackamas County-Thurston County-WA
2894,Clackamas County-Crook County-OR-2021,"Crook County, OR",2021,2020,2021,40,1654000,128,4926000,-88,-3272000,Clackamas County,Clackamas County-Crook County-OR
2895,Clackamas County-Umatilla County-OR-2021,"Umatilla County, OR",2021,2020,2021,31,683000,67,2240000,-36,-1557000,Clackamas County,Clackamas County-Umatilla County-OR
2896,Clackamas County-Benton County-WA-2021,"Benton County, WA",2021,2020,2021,31,952000,46,1105000,-15,-153000,Clackamas County,Clackamas County-Benton County-WA
2897,Clackamas County-El Paso County-CO-2021,"El Paso County, CO",2021,2020,2021,40,1400000,40,1374000,0,26000,Clackamas County,Clackamas County-El Paso County-CO
2899,Clatsop County-Multnomah County-OR-2021,"Multnomah County, OR",2021,2020,2021,292,49171000,165,9453000,127,39718000,Clatsop County,Clatsop County-Multnomah County-OR
2900,Clatsop County-Washington County-OR-2021,"Washington County, OR",2021,2020,2021,209,14953000,137,4456000,72,10497000,Clatsop County,Clatsop County-Washington County-OR
2901,Clatsop County-Clackamas County-OR-2021,"Clackamas County, OR",2021,2020,2021,159,10454000,93,3495000,66,6959000,Clatsop County,Clatsop County-Clackamas County-OR
2902,Clatsop County-King County-WA-2021,"King County, WA",2021,2020,2021,85,11052000,50,2200000,35,8852000,Clatsop County,Clatsop County-King County-WA
2903,Clatsop County-Columbia County-OR-2021,"Columbia County, OR",2021,2020,2021,89,3116000,54,803000,35,2313000,Clatsop County,Clatsop County-Columbia County-OR
2904,Clatsop County-Clark County-WA-2021,"Clark County, WA",2021,2020,2021,70,2068000,66,3230000,4,-1162000,Clatsop County,Clatsop County-Clark County-WA
2905,Clatsop County-Pacific County-WA-2021,"Pacific County, WA",2021,2020,2021,73,1567000,94,3744000,-21,-2177000,Clatsop County,Clatsop County-Pacific County-WA
2906,Clatsop County-Tillamook County-OR-2021,"Tillamook County, OR",2021,2020,2021,63,1914000,54,1913000,9,1000,Clatsop County,Clatsop County-Tillamook County-OR
2907,Clatsop County-Lane County-OR-2021,"Lane County, OR",2021,2020,2021,50,1552000,40,1291000,10,261000,Clatsop County,Clatsop County-Lane County-OR
2908,Clatsop County-Cowlitz County-WA-2021,"Cowlitz County, WA",2021,2020,2021,56,1121000,60,1245000,-4,-124000,Clatsop County,Clatsop County-Cowlitz County-WA
2909,Clatsop County-Maricopa County-AZ-2021,"Maricopa County, AZ",2021,2020,2021,45,1303000,46,1286000,-1,17000,Clatsop County,Clatsop County-Maricopa County-AZ
2910,Clatsop County-Marion County-OR-2021,"Marion County, OR",2021,2020,2021,57,1225000,26,545000,31,680000,Clatsop County,Clatsop County-Marion County-OR
2911,Clatsop County-Deschutes County-OR-2021,"Deschutes County, OR",2021,2020,2021,41,1627000,49,1689000,-8,-62000,Clatsop County,Clatsop County-Deschutes County-OR
2913,Columbia County-Washington County-OR-2021,"Washington County, OR",2021,2020,2021,929,32454000,378,11787000,551,20667000,Columbia County,Columbia County-Washington County-OR
2914,Columbia County-Multnomah County-OR-2021,"Multnomah County, OR",2021,2020,2021,579,20931000,289,9082000,290,11849000,Columbia County,Columbia County-Multnomah County-OR
2915,Columbia County-Clackamas County-OR-2021,"Clackamas County, OR",2021,2020,2021,212,7341000,179,5600000,33,1741000,Columbia County,Columbia County-Clackamas County-OR
2916,Columbia County-Cowlitz County-WA-2021,"Cowlitz County, WA",2021,2020,2021,180,4063000,220,5860000,-40,-1797000,Columbia County,Columbia County-Cowlitz County-WA
2917,Columbia County-Clark County-WA-2021,"Clark County, WA",2021,2020,2021,141,4648000,154,5316000,-13,-668000,Columbia County,Columbia County-Clark County-WA
2918,Columbia County-Marion County-OR-2021,"Marion County, OR",2021,2020,2021,63,1868000,39,1355000,24,513000,Columbia County,Columbia County-Marion County-OR
2919,Columbia County-Clatsop County-OR-2021,"Clatsop County, OR",2021,2020,2021,54,803000,89,3116000,-35,-2313000,Columbia County,Columbia County-Clatsop County-OR
2921,Coos County-Douglas County-OR-2021,"Douglas County, OR",2021,2020,2021,201,4951000,257,4946000,-56,5000,Coos County,Coos County-Douglas County-OR
2922,Coos County-Lane County-OR-2021,"Lane County, OR",2021,2020,2021,188,7244000,190,6313000,-2,931000,Coos County,Coos County-Lane County-OR
2923,Coos County-Jackson County-OR-2021,"Jackson County, OR",2021,2020,2021,119,3710000,103,2604000,16,1106000,Coos County,Coos County-Jackson County-OR
2924,Coos County-Curry County-OR-2021,"Curry County, OR",2021,2020,2021,102,4629000,45,697000,57,3932000,Coos County,Coos County-Curry County-OR
2925,Coos County-Multnomah County-OR-2021,"Multnomah County, OR",2021,2020,2021,77,3997000,55,1397000,22,2600000,Coos County,Coos County-Multnomah County-OR
2926,Coos County-Washington County-OR-2021,"Washington County, OR",2021,2020,2021,77,2751000,66,1980000,11,771000,Coos County,Coos County-Washington County-OR
2927,Coos County-Maricopa County-AZ-2021,"Maricopa County, AZ",2021,2020,2021,66,2101000,47,987000,19,1114000,Coos County,Coos County-Maricopa County-AZ
2928,Coos County-Deschutes County-OR-2021,"Deschutes County, OR",2021,2020,2021,56,1928000,49,1119000,7,809000,Coos County,Coos County-Deschutes County-OR
2929,Coos County-Klamath County-OR-2021,"Klamath County, OR",2021,2020,2021,60,1171000,36,730000,24,441000,Coos County,Coos County-Klamath County-OR
2930,Coos County-Marion County-OR-2021,"Marion County, OR",2021,2020,2021,56,1384000,72,1180000,-16,204000,Coos County,Coos County-Marion County-OR
2931,Coos County-Linn County-OR-2021,"Linn County, OR",2021,2020,2021,48,1452000,79,2270000,-31,-818000,Coos County,Coos County-Linn County-OR
2932,Coos County-Clackamas County-OR-2021,"Clackamas County, OR",2021,2020,2021,47,1809000,45,1891000,2,-82000,Coos County,Coos County-Clackamas County-OR
2933,Coos County-Josephine County-OR-2021,"Josephine County, OR",2021,2020,2021,40,1106000,56,1184000,-16,-78000,Coos County,Coos County-Josephine County-OR
2935,Crook County-Deschutes County-OR-2021,"Deschutes County, OR",2021,2020,2021,826,28314000,402,12685000,424,15629000,Crook County,Crook County-Deschutes County-OR
2936,Crook County-Clackamas County-OR-2021,"Clackamas County, OR",2021,2020,2021,128,4926000,40,1654000,88,3272000,Crook County,Crook County-Clackamas County-OR
2937,Crook County-Lane County-OR-2021,"Lane County, OR",2021,2020,2021,77,3594000,54,1247000,23,2347000,Crook County,Crook County-Lane County-OR
2938,Crook County-Jefferson County-OR-2021,"Jefferson County, OR",2021,2020,2021,76,2246000,74,1791000,2,455000,Crook County,Crook County-Jefferson County-OR
2939,Crook County-Marion County-OR-2021,"Marion County, OR",2021,2020,2021,52,2586000,34,655000,18,1931000,Crook County,Crook County-Marion County-OR
2941,Curry County-Jackson County-OR-2021,"Jackson County, OR",2021,2020,2021,111,3725000,82,2098000,29,1627000,Curry County,Curry County-Jackson County-OR
2942,Curry County-Del Norte County-CA-2021,"Del Norte County, CA",2021,2020,2021,53,1513000,67,1725000,-14,-212000,Curry County,Curry County-Del Norte County-CA
2943,Curry County-Coos County-OR-2021,"Coos County, OR",2021,2020,2021,45,697000,102,4629000,-57,-3932000,Curry County,Curry County-Coos County-OR
2944,Curry County-Lane County-OR-2021,"Lane County, OR",2021,2020,2021,38,1191000,73,2419000,-35,-1228000,Curry County,Curry County-Lane County-OR
2945,Curry County-Josephine County-OR-2021,"Josephine County, OR",2021,2020,2021,34,934000,55,1386000,-21,-452000,Curry County,Curry County-Josephine County-OR
2947,Deschutes County-Multnomah County-OR-2021,"Multnomah County, OR",2021,2020,2021,1217,151745000,394,18368000,823,133377000,Deschutes County,Deschutes County-Multnomah County-OR
2948,Deschutes County-Washington County-OR-2021,"Washington County, OR",2021,2020,2021,750,81159000,294,12585000,456,68574000,Deschutes County,Deschutes County-Washington County-OR
2949,Deschutes County-Clackamas County-OR-2021,"Clackamas County, OR",2021,2020,2021,705,64676000,304,14814000,401,49862000,Deschutes County,Deschutes County-Clackamas County-OR
2950,Deschutes County-Lane County-OR-2021,"Lane County, OR",2021,2020,2021,573,25208000,367,12908000,206,12300000,Deschutes County,Deschutes County-Lane County-OR
2951,Deschutes County-King County-WA-2021,"King County, WA",2021,2020,2021,508,58115000,140,9453000,368,48662000,Deschutes County,Deschutes County-King County-WA
2952,Deschutes County-Los Angeles County-CA-2021,"Los Angeles County, CA",2021,2020,2021,406,23254000,101,4769000,305,18485000,Deschutes County,Deschutes County-Los Angeles County-CA
2953,Deschutes County-Jefferson County-OR-2021,"Jefferson County, OR",2021,2020,2021,394,11135000,614,16535000,-220,-5400000,Deschutes County,Deschutes County-Jefferson County-OR
2954,Deschutes County-Crook County-OR-2021,"Crook County, OR",2021,2020,2021,402,12685000,826,28314000,-424,-15629000,Deschutes County,Deschutes County-Crook County-OR
2955,Deschutes County-Marion County-OR-2021,"Marion County, OR",2021,2020,2021,358,19926000,209,6094000,149,13832000,Deschutes County,Deschutes County-Marion County-OR
2956,Deschutes County-San Diego County-CA-2021,"San Diego County, CA",2021,2020,2021,319,19246000,110,3860000,209,15386000,Deschutes County,Deschutes County-San Diego County-CA
2957,Deschutes County-Maricopa County-AZ-2021,"Maricopa County, AZ",2021,2020,2021,276,14443000,309,14031000,-33,412000,Deschutes County,Deschutes County-Maricopa County-AZ
2958,Deschutes County-Clark County-WA-2021,"Clark County, WA",2021,2020,2021,236,13819000,199,11892000,37,1927000,Deschutes County,Deschutes County-Clark County-WA
2959,Deschutes County-Orange County-CA-2021,"Orange County, CA",2021,2020,2021,227,11503000,85,4371000,142,7132000,Deschutes County,Deschutes County-Orange County-CA
2960,Deschutes County-Jackson County-OR-2021,"Jackson County, OR",2021,2020,2021,191,6683000,208,7711000,-17,-1028000,Deschutes County,Deschutes County-Jackson County-OR
2961,Deschutes County-Benton County-OR-2021,"Benton County, OR",2021,2020,2021,166,6190000,91,3193000,75,2997000,Deschutes County,Deschutes County-Benton County-OR
2962,Deschutes County-Linn County-OR-2021,"Linn County, OR",2021,2020,2021,194,6514000,114,2749000,80,3765000,Deschutes County,Deschutes County-Linn County-OR
2963,Deschutes County-Alameda County-CA-2021,"Alameda County, CA",2021,2020,2021,180,26721000,36,3571000,144,23150000,Deschutes County,Deschutes County-Alameda County-CA
2964,Deschutes County-Klamath County-OR-2021,"Klamath County, OR",2021,2020,2021,161,5020000,291,9032000,-130,-4012000,Deschutes County,Deschutes County-Klamath County-OR
2965,Deschutes County-Riverside County-CA-2021,"Riverside County, CA",2021,2020,2021,155,7795000,94,4755000,61,3040000,Deschutes County,Deschutes County-Riverside County-CA
2966,Deschutes County-Yamhill County-OR-2021,"Yamhill County, OR",2021,2020,2021,144,6550000,86,3281000,58,3269000,Deschutes County,Deschutes County-Yamhill County-OR
2967,Deschutes County-Clark County-NV-2021,"Clark County, NV",2021,2020,2021,94,6939000,126,9174000,-32,-2235000,Deschutes County,Deschutes County-Clark County-NV
2968,Deschutes County-Polk County-OR-2021,"Polk County, OR",2021,2020,2021,97,4051000,69,2213000,28,1838000,Deschutes County,Deschutes County-Polk County-OR
2969,Deschutes County-Ada County-ID-2021,"Ada County, ID",2021,2020,2021,104,5889000,190,6877000,-86,-988000,Deschutes County,Deschutes County-Ada County-ID
2970,Deschutes County-Pierce County-WA-2021,"Pierce County, WA",2021,2020,2021,99,5270000,72,4077000,27,1193000,Deschutes County,Deschutes County-Pierce County-WA
2971,Deschutes County-Denver County-CO-2021,"Denver County, CO",2021,2020,2021,80,4300000,30,1563000,50,2737000,Deschutes County,Deschutes County-Denver County-CO
2972,Deschutes County-Salt Lake County-UT-2021,"Salt Lake County, UT",2021,2020,2021,72,4266000,47,1926000,25,2340000,Deschutes County,Deschutes County-Salt Lake County-UT
2973,Deschutes County-Douglas County-OR-2021,"Douglas County, OR",2021,2020,2021,74,3169000,76,2177000,-2,992000,Deschutes County,Deschutes County-Douglas County-OR
2974,Deschutes County-Pima County-AZ-2021,"Pima County, AZ",2021,2020,2021,66,2576000,111,7650000,-45,-5074000,Deschutes County,Deschutes County-Pima County-AZ
2975,Deschutes County-Travis County-TX-2021,"Travis County, TX",2021,2020,2021,56,5153000,46,2557000,10,2596000,Deschutes County,Deschutes County-Travis County-TX
2976,Deschutes County-Lincoln County-OR-2021,"Lincoln County, OR",2021,2020,2021,61,1554000,93,4395000,-32,-2841000,Deschutes County,Deschutes County-Lincoln County-OR
2977,Deschutes County-Josephine County-OR-2021,"Josephine County, OR",2021,2020,2021,48,1853000,54,1486000,-6,367000,Deschutes County,Deschutes County-Josephine County-OR
2978,Deschutes County-Clatsop County-OR-2021,"Clatsop County, OR",2021,2020,2021,49,1689000,41,1627000,8,62000,Deschutes County,Deschutes County-Clatsop County-OR
2979,Deschutes County-Washoe County-NV-2021,"Washoe County, NV",2021,2020,2021,45,2032000,39,1400000,6,632000,Deschutes County,Deschutes County-Washoe County-NV
2980,Deschutes County-Coos County-OR-2021,"Coos County, OR",2021,2020,2021,49,1119000,56,1928000,-7,-809000,Deschutes County,Deschutes County-Coos County-OR
2981,Deschutes County-San Luis Obispo County-CA-2021,"San Luis Obispo County, CA",2021,2020,2021,47,2442000,28,1982000,19,460000,Deschutes County,Deschutes County-San Luis Obispo County-CA
2982,Deschutes County-Harris County-TX-2021,"Harris County, TX",2021,2020,2021,59,3758000,41,1279000,18,2479000,Deschutes County,Deschutes County-Harris County-TX
2983,Deschutes County-Spokane County-WA-2021,"Spokane County, WA",2021,2020,2021,53,3235000,99,3683000,-46,-448000,Deschutes County,Deschutes County-Spokane County-WA
2984,Deschutes County-Umatilla County-OR-2021,"Umatilla County, OR",2021,2020,2021,39,1535000,65,1443000,-26,92000,Deschutes County,Deschutes County-Umatilla County-OR
2985,Deschutes County-Yavapai County-AZ-2021,"Yavapai County, AZ",2021,2020,2021,28,1189000,64,3683000,-36,-2494000,Deschutes County,Deschutes County-Yavapai County-AZ
2986,Deschutes County-Canyon County-ID-2021,"Canyon County, ID",2021,2020,2021,42,1446000,76,3230000,-34,-1784000,Deschutes County,Deschutes County-Canyon County-ID
2988,Douglas County-Lane County-OR-2021,"Lane County, OR",2021,2020,2021,717,16769000,486,14808000,231,1961000,Douglas County,Douglas County-Lane County-OR
2989,Douglas County-Coos County-OR-2021,"Coos County, OR",2021,2020,2021,257,4946000,201,4951000,56,-5000,Douglas County,Douglas County-Coos County-OR
2990,Douglas County-Jackson County-OR-2021,"Jackson County, OR",2021,2020,2021,209,5392000,132,3353000,77,2039000,Douglas County,Douglas County-Jackson County-OR
2991,Douglas County-Josephine County-OR-2021,"Josephine County, OR",2021,2020,2021,183,3615000,127,2614000,56,1001000,Douglas County,Douglas County-Josephine County-OR
2992,Douglas County-Washington County-OR-2021,"Washington County, OR",2021,2020,2021,130,4689000,91,2083000,39,2606000,Douglas County,Douglas County-Washington County-OR
2993,Douglas County-Multnomah County-OR-2021,"Multnomah County, OR",2021,2020,2021,116,3969000,84,2409000,32,1560000,Douglas County,Douglas County-Multnomah County-OR
2994,Douglas County-Maricopa County-AZ-2021,"Maricopa County, AZ",2021,2020,2021,106,3553000,63,1735000,43,1818000,Douglas County,Douglas County-Maricopa County-AZ
2995,Douglas County-Clackamas County-OR-2021,"Clackamas County, OR",2021,2020,2021,104,4255000,78,2244000,26,2011000,Douglas County,Douglas County-Clackamas County-OR
2996,Douglas County-Marion County-OR-2021,"Marion County, OR",2021,2020,2021,94,2647000,89,2063000,5,584000,Douglas County,Douglas County-Marion County-OR
2997,Douglas County-Linn County-OR-2021,"Linn County, OR",2021,2020,2021,100,2835000,89,2689000,11,146000,Douglas County,Douglas County-Linn County-OR
2998,Douglas County-Klamath County-OR-2021,"Klamath County, OR",2021,2020,2021,82,1667000,63,1785000,19,-118000,Douglas County,Douglas County-Klamath County-OR
2999,Douglas County-Deschutes County-OR-2021,"Deschutes County, OR",2021,2020,2021,76,2177000,74,3169000,2,-992000,Douglas County,Douglas County-Deschutes County-OR
3000,Douglas County-San Diego County-CA-2021,"San Diego County, CA",2021,2020,2021,64,1693000,35,912000,29,781000,Douglas County,Douglas County-San Diego County-CA
3001,Douglas County-Benton County-OR-2021,"Benton County, OR",2021,2020,2021,59,1402000,49,1221000,10,181000,Douglas County,Douglas County-Benton County-OR
3002,Douglas County-Sacramento County-CA-2021,"Sacramento County, CA",2021,2020,2021,44,1968000,28,548000,16,1420000,Douglas County,Douglas County-Sacramento County-CA
3003,Douglas County-Lincoln County-OR-2021,"Lincoln County, OR",2021,2020,2021,41,860000,34,1710000,7,-850000,Douglas County,Douglas County-Lincoln County-OR
3008,Hood River County-Multnomah County-OR-2021,"Multnomah County, OR",2021,2020,2021,328,34914000,129,5754000,199,29160000,Hood River County,Hood River County-Multnomah County-OR
3009,Hood River County-Wasco County-OR-2021,"Wasco County, OR",2021,2020,2021,119,3913000,248,6870000,-129,-2957000,Hood River County,Hood River County-Wasco County-OR
3010,Hood River County-Klickitat County-WA-2021,"Klickitat County, WA",2021,2020,2021,90,3743000,124,7470000,-34,-3727000,Hood River County,Hood River County-Klickitat County-WA
3011,Hood River County-Washington County-OR-2021,"Washington County, OR",2021,2020,2021,60,3628000,51,1820000,9,1808000,Hood River County,Hood River County-Washington County-OR
3012,Hood River County-King County-WA-2021,"King County, WA",2021,2020,2021,37,2829000,27,2431000,10,398000,Hood River County,Hood River County-King County-WA
3013,Hood River County-Clackamas County-OR-2021,"Clackamas County, OR",2021,2020,2021,33,3083000,37,1324000,-4,1759000,Hood River County,Hood River County-Clackamas County-OR
3014,Hood River County-Clark County-WA-2021,"Clark County, WA",2021,2020,2021,39,1409000,66,3212000,-27,-1803000,Hood River County,Hood River County-Clark County-WA
3016,Jackson County-Josephine County-OR-2021,"Josephine County, OR",2021,2020,2021,907,23168000,1094,27563000,-187,-4395000,Jackson County,Jackson County-Josephine County-OR
3017,Jackson County-Multnomah County-OR-2021,"Multnomah County, OR",2021,2020,2021,264,11345000,301,9399000,-37,1946000,Jackson County,Jackson County-Multnomah County-OR
3018,Jackson County-Los Angeles County-CA-2021,"Los Angeles County, CA",2021,2020,2021,282,12678000,113,4086000,169,8592000,Jackson County,Jackson County-Los Angeles County-CA
3019,Jackson County-Lane County-OR-2021,"Lane County, OR",2021,2020,2021,241,6933000,364,10620000,-123,-3687000,Jackson County,Jackson County-Lane County-OR
3020,Jackson County-Klamath County-OR-2021,"Klamath County, OR",2021,2020,2021,210,5320000,229,4910000,-19,410000,Jackson County,Jackson County-Klamath County-OR
3021,Jackson County-Washington County-OR-2021,"Washington County, OR",2021,2020,2021,196,7055000,190,7569000,6,-514000,Jackson County,Jackson County-Washington County-OR
3022,Jackson County-Deschutes County-OR-2021,"Deschutes County, OR",2021,2020,2021,208,7711000,191,6683000,17,1028000,Jackson County,Jackson County-Deschutes County-OR
3023,Jackson County-San Diego County-CA-2021,"San Diego County, CA",2021,2020,2021,175,7572000,75,2150000,100,5422000,Jackson County,Jackson County-San Diego County-CA
3024,Jackson County-Clackamas County-OR-2021,"Clackamas County, OR",2021,2020,2021,165,6061000,131,5364000,34,697000,Jackson County,Jackson County-Clackamas County-OR
3025,Jackson County-Maricopa County-AZ-2021,"Maricopa County, AZ",2021,2020,2021,166,7766000,217,7784000,-51,-18000,Jackson County,Jackson County-Maricopa County-AZ
3026,Jackson County-Santa Clara County-CA-2021,"Santa Clara County, CA",2021,2020,2021,135,9864000,38,1403000,97,8461000,Jackson County,Jackson County-Santa Clara County-CA
3027,Jackson County-Shasta County-CA-2021,"Shasta County, CA",2021,2020,2021,144,4732000,67,1611000,77,3121000,Jackson County,Jackson County-Shasta County-CA
3028,Jackson County-Orange County-CA-2021,"Orange County, CA",2021,2020,2021,136,5026000,45,880000,91,4146000,Jackson County,Jackson County-Orange County-CA
3029,Jackson County-Sonoma County-CA-2021,"Sonoma County, CA",2021,2020,2021,118,5479000,42,1309000,76,4170000,Jackson County,Jackson County-Sonoma County-CA
3030,Jackson County-Douglas County-OR-2021,"Douglas County, OR",2021,2020,2021,132,3353000,209,5392000,-77,-2039000,Jackson County,Jackson County-Douglas County-OR
3031,Jackson County-Marion County-OR-2021,"Marion County, OR",2021,2020,2021,140,2483000,139,3296000,1,-813000,Jackson County,Jackson County-Marion County-OR
3032,Jackson County-Sacramento County-CA-2021,"Sacramento County, CA",2021,2020,2021,107,4374000,66,2070000,41,2304000,Jackson County,Jackson County-Sacramento County-CA
3033,Jackson County-Clark County-NV-2021,"Clark County, NV",2021,2020,2021,113,2851000,133,4567000,-20,-1716000,Jackson County,Jackson County-Clark County-NV
3034,Jackson County-Siskiyou County-CA-2021,"Siskiyou County, CA",2021,2020,2021,127,4625000,84,1829000,43,2796000,Jackson County,Jackson County-Siskiyou County-CA
3035,Jackson County-Contra Costa County-CA-2021,"Contra Costa County, CA",2021,2020,2021,115,5889000,30,1086000,85,4803000,Jackson County,Jackson County-Contra Costa County-CA
3036,Jackson County-King County-WA-2021,"King County, WA",2021,2020,2021,100,6024000,91,4663000,9,1361000,Jackson County,Jackson County-King County-WA
3037,Jackson County-Coos County-OR-2021,"Coos County, OR",2021,2020,2021,103,2604000,119,3710000,-16,-1106000,Jackson County,Jackson County-Coos County-OR
3038,Jackson County-Benton County-OR-2021,"Benton County, OR",2021,2020,2021,82,2358000,99,2808000,-17,-450000,Jackson County,Jackson County-Benton County-OR
3039,Jackson County-San Bernardino County-CA-2021,"San Bernardino County, CA",2021,2020,2021,100,4251000,50,906000,50,3345000,Jackson County,Jackson County-San Bernardino County-CA
3040,Jackson County-Riverside County-CA-2021,"Riverside County, CA",2021,2020,2021,99,2792000,70,1972000,29,820000,Jackson County,Jackson County-Riverside County-CA
3041,Jackson County-Curry County-OR-2021,"Curry County, OR",2021,2020,2021,82,2098000,111,3725000,-29,-1627000,Jackson County,Jackson County-Curry County-OR
3042,Jackson County-Clark County-WA-2021,"Clark County, WA",2021,2020,2021,72,3052000,97,3486000,-25,-434000,Jackson County,Jackson County-Clark County-WA
3043,Jackson County-Pierce County-WA-2021,"Pierce County, WA",2021,2020,2021,75,3056000,71,2444000,4,612000,Jackson County,Jackson County-Pierce County-WA
3044,Jackson County-Humboldt County-CA-2021,"Humboldt County, CA",2021,2020,2021,64,2341000,31,714000,33,1627000,Jackson County,Jackson County-Humboldt County-CA
3045,Jackson County-Washoe County-NV-2021,"Washoe County, NV",2021,2020,2021,60,2456000,58,2073000,2,383000,Jackson County,Jackson County-Washoe County-NV
3046,Jackson County-Ada County-ID-2021,"Ada County, ID",2021,2020,2021,50,1179000,77,2745000,-27,-1566000,Jackson County,Jackson County-Ada County-ID
3047,Jackson County-Linn County-OR-2021,"Linn County, OR",2021,2020,2021,66,1329000,69,1335000,-3,-6000,Jackson County,Jackson County-Linn County-OR
3048,Jackson County-Pima County-AZ-2021,"Pima County, AZ",2021,2020,2021,47,1925000,49,1804000,-2,121000,Jackson County,Jackson County-Pima County-AZ
3049,Jackson County-Del Norte County-CA-2021,"Del Norte County, CA",2021,2020,2021,45,3063000,30,1144000,15,1919000,Jackson County,Jackson County-Del Norte County-CA
3050,Jackson County-Hawaii County-HI-2021,"Hawaii County, HI",2021,2020,2021,45,986000,45,1351000,0,-365000,Jackson County,Jackson County-Hawaii County-HI
3051,Jackson County-Yamhill County-OR-2021,"Yamhill County, OR",2021,2020,2021,44,1005000,41,811000,3,194000,Jackson County,Jackson County-Yamhill County-OR
3052,Jackson County-Snohomish County-WA-2021,"Snohomish County, WA",2021,2020,2021,38,1296000,33,1278000,5,18000,Jackson County,Jackson County-Snohomish County-WA
3053,Jackson County-Salt Lake County-UT-2021,"Salt Lake County, UT",2021,2020,2021,43,1215000,67,1669000,-24,-454000,Jackson County,Jackson County-Salt Lake County-UT
3054,Jackson County-Polk County-OR-2021,"Polk County, OR",2021,2020,2021,35,833000,43,1608000,-8,-775000,Jackson County,Jackson County-Polk County-OR
3056,Jefferson County-Deschutes County-OR-2021,"Deschutes County, OR",2021,2020,2021,614,16535000,394,11135000,220,5400000,Jefferson County,Jefferson County-Deschutes County-OR
3057,Jefferson County-Clackamas County-OR-2021,"Clackamas County, OR",2021,2020,2021,121,5503000,41,1021000,80,4482000,Jefferson County,Jefferson County-Clackamas County-OR
3058,Jefferson County-Multnomah County-OR-2021,"Multnomah County, OR",2021,2020,2021,83,2991000,41,783000,42,2208000,Jefferson County,Jefferson County-Multnomah County-OR
3059,Jefferson County-Crook County-OR-2021,"Crook County, OR",2021,2020,2021,74,1791000,76,2246000,-2,-455000,Jefferson County,Jefferson County-Crook County-OR
3060,Jefferson County-Marion County-OR-2021,"Marion County, OR",2021,2020,2021,62,1891000,128,566000,-66,1325000,Jefferson County,Jefferson County-Marion County-OR
3061,Jefferson County-Washington County-OR-2021,"Washington County, OR",2021,2020,2021,51,2079000,33,561000,18,1518000,Jefferson County,Jefferson County-Washington County-OR
3062,Jefferson County-Lane County-OR-2021,"Lane County, OR",2021,2020,2021,54,1652000,29,865000,25,787000,Jefferson County,Jefferson County-Lane County-OR
3064,Josephine County-Jackson County-OR-2021,"Jackson County, OR",2021,2020,2021,1094,27563000,907,23168000,187,4395000,Josephine County,Josephine County-Jackson County-OR
3065,Josephine County-Multnomah County-OR-2021,"Multnomah County, OR",2021,2020,2021,112,4066000,64,1389000,48,2677000,Josephine County,Josephine County-Multnomah County-OR
3066,Josephine County-Lane County-OR-2021,"Lane County, OR",2021,2020,2021,126,2209000,108,2743000,18,-534000,Josephine County,Josephine County-Lane County-OR
3067,Josephine County-Douglas County-OR-2021,"Douglas County, OR",2021,2020,2021,127,2614000,183,3615000,-56,-1001000,Josephine County,Josephine County-Douglas County-OR
3068,Josephine County-Los Angeles County-CA-2021,"Los Angeles County, CA",2021,2020,2021,88,4850000,34,1320000,54,3530000,Josephine County,Josephine County-Los Angeles County-CA
3069,Josephine County-Deschutes County-OR-2021,"Deschutes County, OR",2021,2020,2021,54,1486000,48,1853000,6,-367000,Josephine County,Josephine County-Deschutes County-OR
3070,Josephine County-Washington County-OR-2021,"Washington County, OR",2021,2020,2021,50,1446000,88,2676000,-38,-1230000,Josephine County,Josephine County-Washington County-OR
3071,Josephine County-Marion County-OR-2021,"Marion County, OR",2021,2020,2021,67,1507000,58,908000,9,599000,Josephine County,Josephine County-Marion County-OR
3072,Josephine County-San Diego County-CA-2021,"San Diego County, CA",2021,2020,2021,49,1777000,32,745000,17,1032000,Josephine County,Josephine County-San Diego County-CA
3073,Josephine County-Maricopa County-AZ-2021,"Maricopa County, AZ",2021,2020,2021,45,1676000,84,2855000,-39,-1179000,Josephine County,Josephine County-Maricopa County-AZ
3074,Josephine County-Coos County-OR-2021,"Coos County, OR",2021,2020,2021,56,1184000,40,1106000,16,78000,Josephine County,Josephine County-Coos County-OR
3075,Josephine County-Curry County-OR-2021,"Curry County, OR",2021,2020,2021,55,1386000,34,934000,21,452000,Josephine County,Josephine County-Curry County-OR
3076,Josephine County-Klamath County-OR-2021,"Klamath County, OR",2021,2020,2021,59,1296000,54,1330000,5,-34000,Josephine County,Josephine County-Klamath County-OR
3077,Josephine County-Clark County-NV-2021,"Clark County, NV",2021,2020,2021,41,1233000,49,1180000,-8,53000,Josephine County,Josephine County-Clark County-NV
3078,Josephine County-Linn County-OR-2021,"Linn County, OR",2021,2020,2021,41,1539000,26,795000,15,744000,Josephine County,Josephine County-Linn County-OR
3079,Josephine County-Clackamas County-OR-2021,"Clackamas County, OR",2021,2020,2021,38,1348000,42,1273000,-4,75000,Josephine County,Josephine County-Clackamas County-OR
3081,Klamath County-Deschutes County-OR-2021,"Deschutes County, OR",2021,2020,2021,291,9032000,161,5020000,130,4012000,Klamath County,Klamath County-Deschutes County-OR
3082,Klamath County-Jackson County-OR-2021,"Jackson County, OR",2021,2020,2021,229,4910000,210,5320000,19,-410000,Klamath County,Klamath County-Jackson County-OR
3083,Klamath County-Lane County-OR-2021,"Lane County, OR",2021,2020,2021,151,4178000,116,3416000,35,762000,Klamath County,Klamath County-Lane County-OR
3084,Klamath County-Multnomah County-OR-2021,"Multnomah County, OR",2021,2020,2021,97,3168000,44,2250000,53,918000,Klamath County,Klamath County-Multnomah County-OR
3085,Klamath County-Siskiyou County-CA-2021,"Siskiyou County, CA",2021,2020,2021,108,1886000,49,1323000,59,563000,Klamath County,Klamath County-Siskiyou County-CA
3086,Klamath County-Washington County-OR-2021,"Washington County, OR",2021,2020,2021,77,2888000,70,1609000,7,1279000,Klamath County,Klamath County-Washington County-OR
3087,Klamath County-Douglas County-OR-2021,"Douglas County, OR",2021,2020,2021,63,1785000,82,1667000,-19,118000,Klamath County,Klamath County-Douglas County-OR
3088,Klamath County-Marion County-OR-2021,"Marion County, OR",2021,2020,2021,69,2089000,58,804000,11,1285000,Klamath County,Klamath County-Marion County-OR
3089,Klamath County-Clackamas County-OR-2021,"Clackamas County, OR",2021,2020,2021,75,2700000,48,2133000,27,567000,Klamath County,Klamath County-Clackamas County-OR
3090,Klamath County-Josephine County-OR-2021,"Josephine County, OR",2021,2020,2021,54,1330000,59,1296000,-5,34000,Klamath County,Klamath County-Josephine County-OR
3091,Klamath County-Linn County-OR-2021,"Linn County, OR",2021,2020,2021,43,965000,62,1635000,-19,-670000,Klamath County,Klamath County-Linn County-OR
3092,Klamath County-Coos County-OR-2021,"Coos County, OR",2021,2020,2021,36,730000,60,1171000,-24,-441000,Klamath County,Klamath County-Coos County-OR
3095,Lane County-Multnomah County-OR-2021,"Multnomah County, OR",2021,2020,2021,675,26128000,779,28001000,-104,-1873000,Lane County,Lane County-Multnomah County-OR
3096,Lane County-Linn County-OR-2021,"Linn County, OR",2021,2020,2021,695,19156000,969,24893000,-274,-5737000,Lane County,Lane County-Linn County-OR
3097,Lane County-Douglas County-OR-2021,"Douglas County, OR",2021,2020,2021,486,14808000,717,16769000,-231,-1961000,Lane County,Lane County-Douglas County-OR
3098,Lane County-Washington County-OR-2021,"Washington County, OR",2021,2020,2021,454,18284000,489,15508000,-35,2776000,Lane County,Lane County-Washington County-OR
3099,Lane County-Marion County-OR-2021,"Marion County, OR",2021,2020,2021,426,11895000,486,13986000,-60,-2091000,Lane County,Lane County-Marion County-OR
3100,Lane County-Los Angeles County-CA-2021,"Los Angeles County, CA",2021,2020,2021,400,18204000,215,7007000,185,11197000,Lane County,Lane County-Los Angeles County-CA
3101,Lane County-Deschutes County-OR-2021,"Deschutes County, OR",2021,2020,2021,367,12908000,573,25208000,-206,-12300000,Lane County,Lane County-Deschutes County-OR
3102,Lane County-Benton County-OR-2021,"Benton County, OR",2021,2020,2021,354,11676000,391,10895000,-37,781000,Lane County,Lane County-Benton County-OR
3103,Lane County-Jackson County-OR-2021,"Jackson County, OR",2021,2020,2021,364,10620000,241,6933000,123,3687000,Lane County,Lane County-Jackson County-OR
3104,Lane County-Clackamas County-OR-2021,"Clackamas County, OR",2021,2020,2021,323,12728000,303,12018000,20,710000,Lane County,Lane County-Clackamas County-OR
3105,Lane County-San Diego County-CA-2021,"San Diego County, CA",2021,2020,2021,236,9046000,133,6615000,103,2431000,Lane County,Lane County-San Diego County-CA
3106,Lane County-King County-WA-2021,"King County, WA",2021,2020,2021,217,11733000,192,10526000,25,1207000,Lane County,Lane County-King County-WA
3107,Lane County-Maricopa County-AZ-2021,"Maricopa County, AZ",2021,2020,2021,245,8348000,303,14916000,-58,-6568000,Lane County,Lane County-Maricopa County-AZ
3108,Lane County-Orange County-CA-2021,"Orange County, CA",2021,2020,2021,206,9995000,72,2038000,134,7957000,Lane County,Lane County-Orange County-CA
3109,Lane County-Coos County-OR-2021,"Coos County, OR",2021,2020,2021,190,6313000,188,7244000,2,-931000,Lane County,Lane County-Coos County-OR
3110,Lane County-Clark County-WA-2021,"Clark County, WA",2021,2020,2021,163,6460000,216,11793000,-53,-5333000,Lane County,Lane County-Clark County-WA
3111,Lane County-Clark County-NV-2021,"Clark County, NV",2021,2020,2021,151,3877000,168,6455000,-17,-2578000,Lane County,Lane County-Clark County-NV
3112,Lane County-Polk County-OR-2021,"Polk County, OR",2021,2020,2021,154,4694000,153,4560000,1,134000,Lane County,Lane County-Polk County-OR
3113,Lane County-Lincoln County-OR-2021,"Lincoln County, OR",2021,2020,2021,139,3936000,151,8761000,-12,-4825000,Lane County,Lane County-Lincoln County-OR
3114,Lane County-Santa Clara County-CA-2021,"Santa Clara County, CA",2021,2020,2021,141,8487000,37,1528000,104,6959000,Lane County,Lane County-Santa Clara County-CA
3115,Lane County-Klamath County-OR-2021,"Klamath County, OR",2021,2020,2021,116,3416000,151,4178000,-35,-762000,Lane County,Lane County-Klamath County-OR
3116,Lane County-Riverside County-CA-2021,"Riverside County, CA",2021,2020,2021,128,3467000,88,3436000,40,31000,Lane County,Lane County-Riverside County-CA
3117,Lane County-Contra Costa County-CA-2021,"Contra Costa County, CA",2021,2020,2021,109,6527000,48,1001000,61,5526000,Lane County,Lane County-Contra Costa County-CA
3118,Lane County-Sacramento County-CA-2021,"Sacramento County, CA",2021,2020,2021,119,3757000,70,1921000,49,1836000,Lane County,Lane County-Sacramento County-CA
3119,Lane County-Josephine County-OR-2021,"Josephine County, OR",2021,2020,2021,108,2743000,126,2209000,-18,534000,Lane County,Lane County-Josephine County-OR
3120,Lane County-Alameda County-CA-2021,"Alameda County, CA",2021,2020,2021,104,7986000,65,3142000,39,4844000,Lane County,Lane County-Alameda County-CA
3121,Lane County-Ada County-ID-2021,"Ada County, ID",2021,2020,2021,112,3756000,193,10801000,-81,-7045000,Lane County,Lane County-Ada County-ID
3122,Lane County-Salt Lake County-UT-2021,"Salt Lake County, UT",2021,2020,2021,115,4170000,63,1750000,52,2420000,Lane County,Lane County-Salt Lake County-UT
3123,Lane County-San Bernardino County-CA-2021,"San Bernardino County, CA",2021,2020,2021,120,3094000,53,1040000,67,2054000,Lane County,Lane County-San Bernardino County-CA
3124,Lane County-Pierce County-WA-2021,"Pierce County, WA",2021,2020,2021,105,3833000,100,2980000,5,853000,Lane County,Lane County-Pierce County-WA
3125,Lane County-Sonoma County-CA-2021,"Sonoma County, CA",2021,2020,2021,92,4302000,44,1794000,48,2508000,Lane County,Lane County-Sonoma County-CA
3126,Lane County-Snohomish County-WA-2021,"Snohomish County, WA",2021,2020,2021,82,3662000,74,3086000,8,576000,Lane County,Lane County-Snohomish County-WA
3127,Lane County-Curry County-OR-2021,"Curry County, OR",2021,2020,2021,73,2419000,38,1191000,35,1228000,Lane County,Lane County-Curry County-OR
3128,Lane County-Washoe County-NV-2021,"Washoe County, NV",2021,2020,2021,71,2227000,50,2223000,21,4000,Lane County,Lane County-Washoe County-NV
3129,Lane County-Yamhill County-OR-2021,"Yamhill County, OR",2021,2020,2021,76,3211000,82,2341000,-6,870000,Lane County,Lane County-Yamhill County-OR
3130,Lane County-Spokane County-WA-2021,"Spokane County, WA",2021,2020,2021,68,2461000,69,2982000,-1,-521000,Lane County,Lane County-Spokane County-WA
3131,Lane County-Pima County-AZ-2021,"Pima County, AZ",2021,2020,2021,59,1877000,77,2424000,-18,-547000,Lane County,Lane County-Pima County-AZ
3132,Lane County-Honolulu County-HI-2021,"Honolulu County, HI",2021,2020,2021,67,1859000,33,1222000,34,637000,Lane County,Lane County-Honolulu County-HI
3133,Lane County-Travis County-TX-2021,"Travis County, TX",2021,2020,2021,54,3017000,49,2219000,5,798000,Lane County,Lane County-Travis County-TX
3134,Lane County-Thurston County-WA-2021,"Thurston County, WA",2021,2020,2021,64,1987000,56,1633000,8,354000,Lane County,Lane County-Thurston County-WA
3135,Lane County-San Francisco County-CA-2021,"San Francisco County, CA",2021,2020,2021,45,3000000,36,1646000,9,1354000,Lane County,Lane County-San Francisco County-CA
3136,Lane County-Umatilla County-OR-2021,"Umatilla County, OR",2021,2020,2021,45,1504000,54,607000,-9,897000,Lane County,Lane County-Umatilla County-OR
3137,Lane County-El Paso County-CO-2021,"El Paso County, CO",2021,2020,2021,47,1566000,47,1616000,0,-50000,Lane County,Lane County-El Paso County-CO
3138,Lane County-Cook County-IL-2021,"Cook County, IL",2021,2020,2021,37,2378000,32,1349000,5,1029000,Lane County,Lane County-Cook County-IL
3139,Lane County-Crook County-OR-2021,"Crook County, OR",2021,2020,2021,54,1247000,77,3594000,-23,-2347000,Lane County,Lane County-Crook County-OR
3140,Lane County-Harris County-TX-2021,"Harris County, TX",2021,2020,2021,51,1620000,36,1014000,15,606000,Lane County,Lane County-Harris County-TX
3141,Lane County-Boulder County-CO-2021,"Boulder County, CO",2021,2020,2021,53,1941000,31,799000,22,1142000,Lane County,Lane County-Boulder County-CO
3142,Lane County-Bexar County-TX-2021,"Bexar County, TX",2021,2020,2021,38,1110000,82,2697000,-44,-1587000,Lane County,Lane County-Bexar County-TX
3143,Lane County-Utah County-UT-2021,"Utah County, UT",2021,2020,2021,55,1467000,62,1805000,-7,-338000,Lane County,Lane County-Utah County-UT
3144,Lane County-Denver County-CO-2021,"Denver County, CO",2021,2020,2021,33,1802000,60,2411000,-27,-609000,Lane County,Lane County-Denver County-CO
3145,Lane County-Clatsop County-OR-2021,"Clatsop County, OR",2021,2020,2021,40,1291000,50,1552000,-10,-261000,Lane County,Lane County-Clatsop County-OR
3146,Lane County-Jefferson County-OR-2021,"Jefferson County, OR",2021,2020,2021,29,865000,54,1652000,-25,-787000,Lane County,Lane County-Jefferson County-OR
3147,Lane County-Tillamook County-OR-2021,"Tillamook County, OR",2021,2020,2021,29,1525000,47,1226000,-18,299000,Lane County,Lane County-Tillamook County-OR
3148,Lane County-New York County-NY-2021,"New York County, NY",2021,2020,2021,22,1191000,24,787000,-2,404000,Lane County,Lane County-New York County-NY
3149,Lane County-Dallas County-TX-2021,"Dallas County, TX",2021,2020,2021,42,1800000,34,1364000,8,436000,Lane County,Lane County-Dallas County-TX
3151,Lincoln County-Multnomah County-OR-2021,"Multnomah County, OR",2021,2020,2021,251,14258000,107,4153000,144,10105000,Lincoln County,Lincoln County-Multnomah County-OR
3152,Lincoln County-Marion County-OR-2021,"Marion County, OR",2021,2020,2021,166,6726000,194,5448000,-28,1278000,Lincoln County,Lincoln County-Marion County-OR
3153,Lincoln County-Clackamas County-OR-2021,"Clackamas County, OR",2021,2020,2021,145,5791000,112,4540000,33,1251000,Lincoln County,Lincoln County-Clackamas County-OR
3154,Lincoln County-Lane County-OR-2021,"Lane County, OR",2021,2020,2021,151,8761000,139,3936000,12,4825000,Lincoln County,Lincoln County-Lane County-OR
3155,Lincoln County-Washington County-OR-2021,"Washington County, OR",2021,2020,2021,158,7660000,120,3344000,38,4316000,Lincoln County,Lincoln County-Washington County-OR
3156,Lincoln County-Benton County-OR-2021,"Benton County, OR",2021,2020,2021,122,3659000,181,4733000,-59,-1074000,Lincoln County,Lincoln County-Benton County-OR
3157,Lincoln County-Linn County-OR-2021,"Linn County, OR",2021,2020,2021,96,2958000,107,2803000,-11,155000,Lincoln County,Lincoln County-Linn County-OR
3158,Lincoln County-Deschutes County-OR-2021,"Deschutes County, OR",2021,2020,2021,93,4395000,61,1554000,32,2841000,Lincoln County,Lincoln County-Deschutes County-OR
3159,Lincoln County-Yamhill County-OR-2021,"Yamhill County, OR",2021,2020,2021,87,2321000,54,1843000,33,478000,Lincoln County,Lincoln County-Yamhill County-OR
3160,Lincoln County-Maricopa County-AZ-2021,"Maricopa County, AZ",2021,2020,2021,59,2615000,47,1414000,12,1201000,Lincoln County,Lincoln County-Maricopa County-AZ
3161,Lincoln County-Polk County-OR-2021,"Polk County, OR",2021,2020,2021,70,2617000,87,2104000,-17,513000,Lincoln County,Lincoln County-Polk County-OR
3162,Lincoln County-Tillamook County-OR-2021,"Tillamook County, OR",2021,2020,2021,66,1741000,31,1217000,35,524000,Lincoln County,Lincoln County-Tillamook County-OR
3163,Lincoln County-Clark County-WA-2021,"Clark County, WA",2021,2020,2021,62,2909000,43,1773000,19,1136000,Lincoln County,Lincoln County-Clark County-WA
3164,Lincoln County-King County-WA-2021,"King County, WA",2021,2020,2021,46,3994000,28,1208000,18,2786000,Lincoln County,Lincoln County-King County-WA
3165,Lincoln County-Clark County-NV-2021,"Clark County, NV",2021,2020,2021,43,1489000,49,1679000,-6,-190000,Lincoln County,Lincoln County-Clark County-NV
3166,Lincoln County-Douglas County-OR-2021,"Douglas County, OR",2021,2020,2021,34,1710000,41,860000,-7,850000,Lincoln County,Lincoln County-Douglas County-OR
3168,Linn County-Marion County-OR-2021,"Marion County, OR",2021,2020,2021,1548,40855000,1018,31366000,530,9489000,Linn County,Linn County-Marion County-OR
3169,Linn County-Benton County-OR-2021,"Benton County, OR",2021,2020,2021,1275,38339000,1249,35227000,26,3112000,Linn County,Linn County-Benton County-OR
3170,Linn County-Lane County-OR-2021,"Lane County, OR",2021,2020,2021,969,24893000,695,19156000,274,5737000,Linn County,Linn County-Lane County-OR
3171,Linn County-Polk County-OR-2021,"Polk County, OR",2021,2020,2021,283,8061000,233,6568000,50,1493000,Linn County,Linn County-Polk County-OR
3172,Linn County-Multnomah County-OR-2021,"Multnomah County, OR",2021,2020,2021,176,5959000,125,3754000,51,2205000,Linn County,Linn County-Multnomah County-OR
3173,Linn County-Washington County-OR-2021,"Washington County, OR",2021,2020,2021,222,8586000,140,4806000,82,3780000,Linn County,Linn County-Washington County-OR
3174,Linn County-Clackamas County-OR-2021,"Clackamas County, OR",2021,2020,2021,164,6157000,135,4139000,29,2018000,Linn County,Linn County-Clackamas County-OR
3175,Linn County-Deschutes County-OR-2021,"Deschutes County, OR",2021,2020,2021,114,2749000,194,6514000,-80,-3765000,Linn County,Linn County-Deschutes County-OR
3176,Linn County-Lincoln County-OR-2021,"Lincoln County, OR",2021,2020,2021,107,2803000,96,2958000,11,-155000,Linn County,Linn County-Lincoln County-OR
3177,Linn County-Douglas County-OR-2021,"Douglas County, OR",2021,2020,2021,89,2689000,100,2835000,-11,-146000,Linn County,Linn County-Douglas County-OR
3178,Linn County-Yamhill County-OR-2021,"Yamhill County, OR",2021,2020,2021,103,2374000,67,1871000,36,503000,Linn County,Linn County-Yamhill County-OR
3179,Linn County-Los Angeles County-CA-2021,"Los Angeles County, CA",2021,2020,2021,64,2310000,28,1153000,36,1157000,Linn County,Linn County-Los Angeles County-CA
3180,Linn County-Maricopa County-AZ-2021,"Maricopa County, AZ",2021,2020,2021,67,2296000,114,4204000,-47,-1908000,Linn County,Linn County-Maricopa County-AZ
3181,Linn County-Coos County-OR-2021,"Coos County, OR",2021,2020,2021,79,2270000,48,1452000,31,818000,Linn County,Linn County-Coos County-OR
3182,Linn County-Clark County-WA-2021,"Clark County, WA",2021,2020,2021,74,1670000,53,2211000,21,-541000,Linn County,Linn County-Clark County-WA
3183,Linn County-Jackson County-OR-2021,"Jackson County, OR",2021,2020,2021,69,1335000,66,1329000,3,6000,Linn County,Linn County-Jackson County-OR
3184,Linn County-Klamath County-OR-2021,"Klamath County, OR",2021,2020,2021,62,1635000,43,965000,19,670000,Linn County,Linn County-Klamath County-OR
3185,Linn County-Pierce County-WA-2021,"Pierce County, WA",2021,2020,2021,49,1336000,34,879000,15,457000,Linn County,Linn County-Pierce County-WA
3186,Linn County-King County-WA-2021,"King County, WA",2021,2020,2021,44,1207000,40,1400000,4,-193000,Linn County,Linn County-King County-WA
3187,Linn County-Josephine County-OR-2021,"Josephine County, OR",2021,2020,2021,26,795000,41,1539000,-15,-744000,Linn County,Linn County-Josephine County-OR
3189,Malheur County-Ada County-ID-2021,"Ada County, ID",2021,2020,2021,203,4826000,107,2046000,96,2780000,Malheur County,Malheur County-Ada County-ID
3190,Malheur County-Canyon County-ID-2021,"Canyon County, ID",2021,2020,2021,241,4202000,214,4182000,27,20000,Malheur County,Malheur County-Canyon County-ID
3191,Malheur County-Payette County-ID-2021,"Payette County, ID",2021,2020,2021,241,4381000,254,8591000,-13,-4210000,Malheur County,Malheur County-Payette County-ID
3192,Malheur County-Washington County-ID-2021,"Washington County, ID",2021,2020,2021,49,1126000,61,889000,-12,237000,Malheur County,Malheur County-Washington County-ID
3194,Marion County-Polk County-OR-2021,"Polk County, OR",2021,2020,2021,2208,63857000,2428,70066000,-220,-6209000,Marion County,Marion County-Polk County-OR
3195,Marion County-Clackamas County-OR-2021,"Clackamas County, OR",2021,2020,2021,1738,60459000,1307,42037000,431,18422000,Marion County,Marion County-Clackamas County-OR
3196,Marion County-Washington County-OR-2021,"Washington County, OR",2021,2020,2021,1534,48869000,964,27495000,570,21374000,Marion County,Marion County-Washington County-OR
3197,Marion County-Multnomah County-OR-2021,"Multnomah County, OR",2021,2020,2021,1140,39266000,841,25825000,299,13441000,Marion County,Marion County-Multnomah County-OR
3198,Marion County-Linn County-OR-2021,"Linn County, OR",2021,2020,2021,1018,31366000,1548,40855000,-530,-9489000,Marion County,Marion County-Linn County-OR
3199,Marion County-Lane County-OR-2021,"Lane County, OR",2021,2020,2021,486,13986000,426,11895000,60,2091000,Marion County,Marion County-Lane County-OR
3200,Marion County-Yamhill County-OR-2021,"Yamhill County, OR",2021,2020,2021,522,12872000,420,11865000,102,1007000,Marion County,Marion County-Yamhill County-OR
3201,Marion County-Umatilla County-OR-2021,"Umatilla County, OR",2021,2020,2021,284,1175000,119,2137000,165,-962000,Marion County,Marion County-Umatilla County-OR
3202,Marion County-Benton County-OR-2021,"Benton County, OR",2021,2020,2021,286,9635000,351,8829000,-65,806000,Marion County,Marion County-Benton County-OR
3203,Marion County-Los Angeles County-CA-2021,"Los Angeles County, CA",2021,2020,2021,263,8293000,112,2905000,151,5388000,Marion County,Marion County-Los Angeles County-CA
3204,Marion County-Clark County-WA-2021,"Clark County, WA",2021,2020,2021,265,11081000,328,10141000,-63,940000,Marion County,Marion County-Clark County-WA
3205,Marion County-Deschutes County-OR-2021,"Deschutes County, OR",2021,2020,2021,209,6094000,358,19926000,-149,-13832000,Marion County,Marion County-Deschutes County-OR
3206,Marion County-Maricopa County-AZ-2021,"Maricopa County, AZ",2021,2020,2021,183,6169000,295,12234000,-112,-6065000,Marion County,Marion County-Maricopa County-AZ
3207,Marion County-Lincoln County-OR-2021,"Lincoln County, OR",2021,2020,2021,194,5448000,166,6726000,28,-1278000,Marion County,Marion County-Lincoln County-OR
3208,Marion County-Jefferson County-OR-2021,"Jefferson County, OR",2021,2020,2021,128,566000,62,1891000,66,-1325000,Marion County,Marion County-Jefferson County-OR
3209,Marion County-Jackson County-OR-2021,"Jackson County, OR",2021,2020,2021,139,3296000,140,2483000,-1,813000,Marion County,Marion County-Jackson County-OR
3210,Marion County-King County-WA-2021,"King County, WA",2021,2020,2021,127,5427000,131,4134000,-4,1293000,Marion County,Marion County-King County-WA
3211,Marion County-San Diego County-CA-2021,"San Diego County, CA",2021,2020,2021,150,5431000,94,1743000,56,3688000,Marion County,Marion County-San Diego County-CA
3212,Marion County-Riverside County-CA-2021,"Riverside County, CA",2021,2020,2021,141,6134000,66,2149000,75,3985000,Marion County,Marion County-Riverside County-CA
3213,Marion County-Pierce County-WA-2021,"Pierce County, WA",2021,2020,2021,102,3520000,100,2386000,2,1134000,Marion County,Marion County-Pierce County-WA
3214,Marion County-Clark County-NV-2021,"Clark County, NV",2021,2020,2021,117,3073000,91,2627000,26,446000,Marion County,Marion County-Clark County-NV
3215,Marion County-Douglas County-OR-2021,"Douglas County, OR",2021,2020,2021,89,2063000,94,2647000,-5,-584000,Marion County,Marion County-Douglas County-OR
3216,Marion County-Orange County-CA-2021,"Orange County, CA",2021,2020,2021,107,3865000,52,2563000,55,1302000,Marion County,Marion County-Orange County-CA
3217,Marion County-Snohomish County-WA-2021,"Snohomish County, WA",2021,2020,2021,78,3253000,62,1770000,16,1483000,Marion County,Marion County-Snohomish County-WA
3218,Marion County-Sacramento County-CA-2021,"Sacramento County, CA",2021,2020,2021,84,2576000,42,1635000,42,941000,Marion County,Marion County-Sacramento County-CA
3219,Marion County-Coos County-OR-2021,"Coos County, OR",2021,2020,2021,72,1180000,56,1384000,16,-204000,Marion County,Marion County-Coos County-OR
3220,Marion County-Klamath County-OR-2021,"Klamath County, OR",2021,2020,2021,58,804000,69,2089000,-11,-1285000,Marion County,Marion County-Klamath County-OR
3221,Marion County-Josephine County-OR-2021,"Josephine County, OR",2021,2020,2021,58,908000,67,1507000,-9,-599000,Marion County,Marion County-Josephine County-OR
3222,Marion County-Ada County-ID-2021,"Ada County, ID",2021,2020,2021,65,2636000,79,4720000,-14,-2084000,Marion County,Marion County-Ada County-ID
3223,Marion County-Spokane County-WA-2021,"Spokane County, WA",2021,2020,2021,61,1638000,69,2024000,-8,-386000,Marion County,Marion County-Spokane County-WA
3224,Marion County-Thurston County-WA-2021,"Thurston County, WA",2021,2020,2021,55,1870000,76,2207000,-21,-337000,Marion County,Marion County-Thurston County-WA
3225,Marion County-Columbia County-OR-2021,"Columbia County, OR",2021,2020,2021,39,1355000,63,1868000,-24,-513000,Marion County,Marion County-Columbia County-OR
3226,Marion County-Tillamook County-OR-2021,"Tillamook County, OR",2021,2020,2021,45,760000,58,1458000,-13,-698000,Marion County,Marion County-Tillamook County-OR
3227,Marion County-Pima County-AZ-2021,"Pima County, AZ",2021,2020,2021,53,1097000,65,2221000,-12,-1124000,Marion County,Marion County-Pima County-AZ
3228,Marion County-Salt Lake County-UT-2021,"Salt Lake County, UT",2021,2020,2021,41,1089000,41,1343000,0,-254000,Marion County,Marion County-Salt Lake County-UT
3229,Marion County-Canyon County-ID-2021,"Canyon County, ID",2021,2020,2021,48,801000,69,2210000,-21,-1409000,Marion County,Marion County-Canyon County-ID
3230,Marion County-Cowlitz County-WA-2021,"Cowlitz County, WA",2021,2020,2021,43,864000,44,740000,-1,124000,Marion County,Marion County-Cowlitz County-WA
3231,Marion County-Clatsop County-OR-2021,"Clatsop County, OR",2021,2020,2021,26,545000,57,1225000,-31,-680000,Marion County,Marion County-Clatsop County-OR
3232,Marion County-Crook County-OR-2021,"Crook County, OR",2021,2020,2021,34,655000,52,2586000,-18,-1931000,Marion County,Marion County-Crook County-OR
3234,Morrow County-Umatilla County-OR-2021,"Umatilla County, OR",2021,2020,2021,279,7216000,254,5609000,25,1607000,Morrow County,Morrow County-Umatilla County-OR
3235,Morrow County-Benton County-WA-2021,"Benton County, WA",2021,2020,2021,44,901000,42,2270000,2,-1369000,Morrow County,Morrow County-Benton County-WA
3237,Multnomah County-Washington County-OR-2021,"Washington County, OR",2021,2020,2021,5956,349406000,8058,449518000,-2102,-100112000,Multnomah County,Multnomah County-Washington County-OR
3238,Multnomah County-Clackamas County-OR-2021,"Clackamas County, OR",2021,2020,2021,6068,222634000,10819,583414000,-4751,-360780000,Multnomah County,Multnomah County-Clackamas County-OR
3239,Multnomah County-Clark County-WA-2021,"Clark County, WA",2021,2020,2021,2597,85766000,5725,328345000,-3128,-242579000,Multnomah County,Multnomah County-Clark County-WA
3240,Multnomah County-Los Angeles County-CA-2021,"Los Angeles County, CA",2021,2020,2021,1432,77845000,764,45570000,668,32275000,Multnomah County,Multnomah County-Los Angeles County-CA
3241,Multnomah County-King County-WA-2021,"King County, WA",2021,2020,2021,1274,90430000,1116,89010000,158,1420000,Multnomah County,Multnomah County-King County-WA
3242,Multnomah County-Lane County-OR-2021,"Lane County, OR",2021,2020,2021,779,28001000,675,26128000,104,1873000,Multnomah County,Multnomah County-Lane County-OR
3243,Multnomah County-Marion County-OR-2021,"Marion County, OR",2021,2020,2021,841,25825000,1140,39266000,-299,-13441000,Multnomah County,Multnomah County-Marion County-OR
3244,Multnomah County-Alameda County-CA-2021,"Alameda County, CA",2021,2020,2021,750,66325000,198,12681000,552,53644000,Multnomah County,Multnomah County-Alameda County-CA
3245,Multnomah County-San Francisco County-CA-2021,"San Francisco County, CA",2021,2020,2021,609,91131000,222,21421000,387,69710000,Multnomah County,Multnomah County-San Francisco County-CA
3246,Multnomah County-San Diego County-CA-2021,"San Diego County, CA",2021,2020,2021,596,30927000,479,24109000,117,6818000,Multnomah County,Multnomah County-San Diego County-CA
3247,Multnomah County-Maricopa County-AZ-2021,"Maricopa County, AZ",2021,2020,2021,520,20533000,798,52506000,-278,-31973000,Multnomah County,Multnomah County-Maricopa County-AZ
3248,Multnomah County-Cook County-IL-2021,"Cook County, IL",2021,2020,2021,415,26548000,233,14068000,182,12480000,Multnomah County,Multnomah County-Cook County-IL
3249,Multnomah County-Deschutes County-OR-2021,"Deschutes County, OR",2021,2020,2021,394,18368000,1217,151745000,-823,-133377000,Multnomah County,Multnomah County-Deschutes County-OR
3250,Multnomah County-Kings County-NY-2021,"Kings County, NY",2021,2020,2021,389,27061000,188,11876000,201,15185000,Multnomah County,Multnomah County-Kings County-NY
3251,Multnomah County-Orange County-CA-2021,"Orange County, CA",2021,2020,2021,342,17107000,267,15460000,75,1647000,Multnomah County,Multnomah County-Orange County-CA
3252,Multnomah County-Santa Clara County-CA-2021,"Santa Clara County, CA",2021,2020,2021,389,41330000,205,16844000,184,24486000,Multnomah County,Multnomah County-Santa Clara County-CA
3253,Multnomah County-Benton County-OR-2021,"Benton County, OR",2021,2020,2021,314,10150000,276,12716000,38,-2566000,Multnomah County,Multnomah County-Benton County-OR
3254,Multnomah County-Jackson County-OR-2021,"Jackson County, OR",2021,2020,2021,301,9399000,264,11345000,37,-1946000,Multnomah County,Multnomah County-Jackson County-OR
3255,Multnomah County-Clark County-NV-2021,"Clark County, NV",2021,2020,2021,326,9125000,409,24623000,-83,-15498000,Multnomah County,Multnomah County-Clark County-NV
3256,Multnomah County-Yamhill County-OR-2021,"Yamhill County, OR",2021,2020,2021,294,7757000,503,23330000,-209,-15573000,Multnomah County,Multnomah County-Yamhill County-OR
3257,Multnomah County-Pierce County-WA-2021,"Pierce County, WA",2021,2020,2021,291,12074000,279,14588000,12,-2514000,Multnomah County,Multnomah County-Pierce County-WA
3258,Multnomah County-Columbia County-OR-2021,"Columbia County, OR",2021,2020,2021,289,9082000,579,20931000,-290,-11849000,Multnomah County,Multnomah County-Columbia County-OR
3259,Multnomah County-Sacramento County-CA-2021,"Sacramento County, CA",2021,2020,2021,242,11418000,193,8407000,49,3011000,Multnomah County,Multnomah County-Sacramento County-CA
3260,Multnomah County-Travis County-TX-2021,"Travis County, TX",2021,2020,2021,229,14605000,248,24297000,-19,-9692000,Multnomah County,Multnomah County-Travis County-TX
3261,Multnomah County-Denver County-CO-2021,"Denver County, CO",2021,2020,2021,207,11957000,217,11372000,-10,585000,Multnomah County,Multnomah County-Denver County-CO
3262,Multnomah County-Hennepin County-MN-2021,"Hennepin County, MN",2021,2020,2021,193,10203000,164,9120000,29,1083000,Multnomah County,Multnomah County-Hennepin County-MN
3263,Multnomah County-Riverside County-CA-2021,"Riverside County, CA",2021,2020,2021,219,9909000,215,22181000,4,-12272000,Multnomah County,Multnomah County-Riverside County-CA
3264,Multnomah County-San Mateo County-CA-2021,"San Mateo County, CA",2021,2020,2021,237,34881000,68,5481000,169,29400000,Multnomah County,Multnomah County-San Mateo County-CA
3265,Multnomah County-Contra Costa County-CA-2021,"Contra Costa County, CA",2021,2020,2021,241,16662000,91,5758000,150,10904000,Multnomah County,Multnomah County-Contra Costa County-CA
3266,Multnomah County-Salt Lake County-UT-2021,"Salt Lake County, UT",2021,2020,2021,199,9388000,231,9175000,-32,213000,Multnomah County,Multnomah County-Salt Lake County-UT
3267,Multnomah County-Sonoma County-CA-2021,"Sonoma County, CA",2021,2020,2021,199,9362000,84,4646000,115,4716000,Multnomah County,Multnomah County-Sonoma County-CA
3268,Multnomah County-Spokane County-WA-2021,"Spokane County, WA",2021,2020,2021,203,7603000,261,11004000,-58,-3401000,Multnomah County,Multnomah County-Spokane County-WA
3269,Multnomah County-Honolulu County-HI-2021,"Honolulu County, HI",2021,2020,2021,228,6895000,150,5749000,78,1146000,Multnomah County,Multnomah County-Honolulu County-HI
3270,Multnomah County-Snohomish County-WA-2021,"Snohomish County, WA",2021,2020,2021,179,7971000,191,8944000,-12,-973000,Multnomah County,Multnomah County-Snohomish County-WA
3271,Multnomah County-New York County-NY-2021,"New York County, NY",2021,2020,2021,161,14296000,168,15687000,-7,-1391000,Multnomah County,Multnomah County-New York County-NY
3272,Multnomah County-Ada County-ID-2021,"Ada County, ID",2021,2020,2021,151,5348000,311,15122000,-160,-9774000,Multnomah County,Multnomah County-Ada County-ID
3273,Multnomah County-Clatsop County-OR-2021,"Clatsop County, OR",2021,2020,2021,165,9453000,292,49171000,-127,-39718000,Multnomah County,Multnomah County-Clatsop County-OR
3274,Multnomah County-San Bernardino County-CA-2021,"San Bernardino County, CA",2021,2020,2021,147,5703000,86,3427000,61,2276000,Multnomah County,Multnomah County-San Bernardino County-CA
3275,Multnomah County-Thurston County-WA-2021,"Thurston County, WA",2021,2020,2021,165,6734000,150,5564000,15,1170000,Multnomah County,Multnomah County-Thurston County-WA
3276,Multnomah County-Polk County-OR-2021,"Polk County, OR",2021,2020,2021,127,4491000,212,7310000,-85,-2819000,Multnomah County,Multnomah County-Polk County-OR
3277,Multnomah County-District of Columbia-DC-2021,"District of Columbia, DC",2021,2020,2021,119,9107000,108,6966000,11,2141000,Multnomah County,Multnomah County-District of Columbia-DC
3278,Multnomah County-Pima County-AZ-2021,"Pima County, AZ",2021,2020,2021,140,4380000,212,12121000,-72,-7741000,Multnomah County,Multnomah County-Pima County-AZ
3279,Multnomah County-Linn County-OR-2021,"Linn County, OR",2021,2020,2021,125,3754000,176,5959000,-51,-2205000,Multnomah County,Multnomah County-Linn County-OR
3280,Multnomah County-Cowlitz County-WA-2021,"Cowlitz County, WA",2021,2020,2021,144,3676000,322,16155000,-178,-12479000,Multnomah County,Multnomah County-Cowlitz County-WA
3281,Multnomah County-Harris County-TX-2021,"Harris County, TX",2021,2020,2021,136,6828000,160,9851000,-24,-3023000,Multnomah County,Multnomah County-Harris County-TX
3282,Multnomah County-Whatcom County-WA-2021,"Whatcom County, WA",2021,2020,2021,110,3492000,158,8918000,-48,-5426000,Multnomah County,Multnomah County-Whatcom County-WA
3283,Multnomah County-Hood River County-OR-2021,"Hood River County, OR",2021,2020,2021,129,5754000,328,34914000,-199,-29160000,Multnomah County,Multnomah County-Hood River County-OR
3284,Multnomah County-Middlesex County-MA-2021,"Middlesex County, MA",2021,2020,2021,119,11201000,125,6950000,-6,4251000,Multnomah County,Multnomah County-Middlesex County-MA
3285,Multnomah County-Marin County-CA-2021,"Marin County, CA",2021,2020,2021,119,9183000,34,1968000,85,7215000,Multnomah County,Multnomah County-Marin County-CA
3286,Multnomah County-Philadelphia County-PA-2021,"Philadelphia County, PA",2021,2020,2021,95,5680000,86,4368000,9,1312000,Multnomah County,Multnomah County-Philadelphia County-PA
3287,Multnomah County-Dallas County-TX-2021,"Dallas County, TX",2021,2020,2021,114,5211000,157,9591000,-43,-4380000,Multnomah County,Multnomah County-Dallas County-TX
3288,Multnomah County-Santa Cruz County-CA-2021,"Santa Cruz County, CA",2021,2020,2021,94,4855000,48,2437000,46,2418000,Multnomah County,Multnomah County-Santa Cruz County-CA
3289,Multnomah County-Ventura County-CA-2021,"Ventura County, CA",2021,2020,2021,102,3679000,72,4293000,30,-614000,Multnomah County,Multnomah County-Ventura County-CA
3290,Multnomah County-Lincoln County-OR-2021,"Lincoln County, OR",2021,2020,2021,107,4153000,251,14258000,-144,-10105000,Multnomah County,Multnomah County-Lincoln County-OR
3291,Multnomah County-Santa Barbara County-CA-2021,"Santa Barbara County, CA",2021,2020,2021,97,4747000,71,4340000,26,407000,Multnomah County,Multnomah County-Santa Barbara County-CA
3292,Multnomah County-Washoe County-NV-2021,"Washoe County, NV",2021,2020,2021,96,3390000,118,7952000,-22,-4562000,Multnomah County,Multnomah County-Washoe County-NV
3293,Multnomah County-Fresno County-CA-2021,"Fresno County, CA",2021,2020,2021,102,5005000,47,1395000,55,3610000,Multnomah County,Multnomah County-Fresno County-CA
3294,Multnomah County-Douglas County-OR-2021,"Douglas County, OR",2021,2020,2021,84,2409000,116,3969000,-32,-1560000,Multnomah County,Multnomah County-Douglas County-OR
3295,Multnomah County-Dane County-WI-2021,"Dane County, WI",2021,2020,2021,80,3950000,60,2230000,20,1720000,Multnomah County,Multnomah County-Dane County-WI
3296,Multnomah County-Boulder County-CO-2021,"Boulder County, CO",2021,2020,2021,74,4091000,128,6915000,-54,-2824000,Multnomah County,Multnomah County-Boulder County-CO
3297,Multnomah County-Suffolk County-MA-2021,"Suffolk County, MA",2021,2020,2021,71,5734000,89,4842000,-18,892000,Multnomah County,Multnomah County-Suffolk County-MA
3298,Multnomah County-Larimer County-CO-2021,"Larimer County, CO",2021,2020,2021,89,2815000,47,1521000,42,1294000,Multnomah County,Multnomah County-Larimer County-CO
3299,Multnomah County-Kitsap County-WA-2021,"Kitsap County, WA",2021,2020,2021,76,3283000,115,10573000,-39,-7290000,Multnomah County,Multnomah County-Kitsap County-WA
3300,Multnomah County-Anchorage Municipality-AK-2021,"Anchorage Municipality, AK",2021,2020,2021,82,3622000,93,3870000,-11,-248000,Multnomah County,Multnomah County-Anchorage Municipality-AK
3301,Multnomah County-Monterey County-CA-2021,"Monterey County, CA",2021,2020,2021,82,3765000,24,1046000,58,2719000,Multnomah County,Multnomah County-Monterey County-CA
3302,Multnomah County-Umatilla County-OR-2021,"Umatilla County, OR",2021,2020,2021,79,3615000,114,2689000,-35,926000,Multnomah County,Multnomah County-Umatilla County-OR
3303,Multnomah County-Missoula County-MT-2021,"Missoula County, MT",2021,2020,2021,65,1815000,86,3819000,-21,-2004000,Multnomah County,Multnomah County-Missoula County-MT
3304,Multnomah County-Bernalillo County-NM-2021,"Bernalillo County, NM",2021,2020,2021,75,3277000,103,4282000,-28,-1005000,Multnomah County,Multnomah County-Bernalillo County-NM
3305,Multnomah County-Davidson County-TN-2021,"Davidson County, TN",2021,2020,2021,69,5314000,82,4407000,-13,907000,Multnomah County,Multnomah County-Davidson County-TN
3306,Multnomah County-Milwaukee County-WI-2021,"Milwaukee County, WI",2021,2020,2021,68,5371000,69,2505000,-1,2866000,Multnomah County,Multnomah County-Milwaukee County-WI
3307,Multnomah County-Orleans Parish-LA-2021,"Orleans Parish, LA",2021,2020,2021,68,2237000,37,2014000,31,223000,Multnomah County,Multnomah County-Orleans Parish-LA
3308,Multnomah County-Franklin County-OH-2021,"Franklin County, OH",2021,2020,2021,74,3645000,105,4182000,-31,-537000,Multnomah County,Multnomah County-Franklin County-OH
3309,Multnomah County-Tillamook County-OR-2021,"Tillamook County, OR",2021,2020,2021,77,3212000,285,38605000,-208,-35393000,Multnomah County,Multnomah County-Tillamook County-OR
3310,Multnomah County-Arapahoe County-CO-2021,"Arapahoe County, CO",2021,2020,2021,74,2385000,87,4114000,-13,-1729000,Multnomah County,Multnomah County-Arapahoe County-CO
3311,Multnomah County-Orange County-FL-2021,"Orange County, FL",2021,2020,2021,59,2228000,81,3520000,-22,-1292000,Multnomah County,Multnomah County-Orange County-FL
3312,Multnomah County-Wasco County-OR-2021,"Wasco County, OR",2021,2020,2021,84,2287000,126,6181000,-42,-3894000,Multnomah County,Multnomah County-Wasco County-OR
3313,Multnomah County-Fulton County-GA-2021,"Fulton County, GA",2021,2020,2021,67,5449000,71,3520000,-4,1929000,Multnomah County,Multnomah County-Fulton County-GA
3314,Multnomah County-Allegheny County-PA-2021,"Allegheny County, PA",2021,2020,2021,67,4723000,96,6710000,-29,-1987000,Multnomah County,Multnomah County-Allegheny County-PA
3315,Multnomah County-Tarrant County-TX-2021,"Tarrant County, TX",2021,2020,2021,78,2568000,83,3757000,-5,-1189000,Multnomah County,Multnomah County-Tarrant County-TX
3316,Multnomah County-Jefferson County-CO-2021,"Jefferson County, CO",2021,2020,2021,70,3413000,68,4470000,2,-1057000,Multnomah County,Multnomah County-Jefferson County-CO
3317,Multnomah County-Miami-Dade County-FL-2021,"Miami-Dade County, FL",2021,2020,2021,73,3332000,81,4134000,-8,-802000,Multnomah County,Multnomah County-Miami-Dade County-FL
3318,Multnomah County-Kern County-CA-2021,"Kern County, CA",2021,2020,2021,68,2300000,36,813000,32,1487000,Multnomah County,Multnomah County-Kern County-CA
3319,Multnomah County-Josephine County-OR-2021,"Josephine County, OR",2021,2020,2021,64,1389000,112,4066000,-48,-2677000,Multnomah County,Multnomah County-Josephine County-OR
3320,Multnomah County-Humboldt County-CA-2021,"Humboldt County, CA",2021,2020,2021,63,1816000,39,1262000,24,554000,Multnomah County,Multnomah County-Humboldt County-CA
3321,Multnomah County-Queens County-NY-2021,"Queens County, NY",2021,2020,2021,67,4125000,48,2755000,19,1370000,Multnomah County,Multnomah County-Queens County-NY
3322,Multnomah County-Hillsborough County-FL-2021,"Hillsborough County, FL",2021,2020,2021,58,2333000,106,4686000,-48,-2353000,Multnomah County,Multnomah County-Hillsborough County-FL
3323,Multnomah County-Bexar County-TX-2021,"Bexar County, TX",2021,2020,2021,67,3614000,134,5577000,-67,-1963000,Multnomah County,Multnomah County-Bexar County-TX
3324,Multnomah County-Pinellas County-FL-2021,"Pinellas County, FL",2021,2020,2021,62,3113000,65,3430000,-3,-317000,Multnomah County,Multnomah County-Pinellas County-FL
3325,Multnomah County-DeKalb County-GA-2021,"DeKalb County, GA",2021,2020,2021,82,3212000,40,2615000,42,597000,Multnomah County,Multnomah County-DeKalb County-GA
3326,Multnomah County-Ramsey County-MN-2021,"Ramsey County, MN",2021,2020,2021,56,2396000,46,1236000,10,1160000,Multnomah County,Multnomah County-Ramsey County-MN
3327,Multnomah County-Coos County-OR-2021,"Coos County, OR",2021,2020,2021,55,1397000,77,3997000,-22,-2600000,Multnomah County,Multnomah County-Coos County-OR
3328,Multnomah County-Cuyahoga County-OH-2021,"Cuyahoga County, OH",2021,2020,2021,60,2908000,50,2002000,10,906000,Multnomah County,Multnomah County-Cuyahoga County-OH
3329,Multnomah County-El Paso County-CO-2021,"El Paso County, CO",2021,2020,2021,63,1683000,71,2278000,-8,-595000,Multnomah County,Multnomah County-El Paso County-CO
3330,Multnomah County-Jackson County-MO-2021,"Jackson County, MO",2021,2020,2021,61,2580000,51,1880000,10,700000,Multnomah County,Multnomah County-Jackson County-MO
3331,Multnomah County-San Joaquin County-CA-2021,"San Joaquin County, CA",2021,2020,2021,67,2539000,28,1144000,39,1395000,Multnomah County,Multnomah County-San Joaquin County-CA
3332,Multnomah County-Marion County-IN-2021,"Marion County, IN",2021,2020,2021,53,2783000,47,1346000,6,1437000,Multnomah County,Multnomah County-Marion County-IN
3333,Multnomah County-Benton County-WA-2021,"Benton County, WA",2021,2020,2021,59,2166000,93,3105000,-34,-939000,Multnomah County,Multnomah County-Benton County-WA
3334,Multnomah County-Placer County-CA-2021,"Placer County, CA",2021,2020,2021,50,2327000,63,2615000,-13,-288000,Multnomah County,Multnomah County-Placer County-CA
3335,Multnomah County-San Luis Obispo County-CA-2021,"San Luis Obispo County, CA",2021,2020,2021,49,1955000,78,3929000,-29,-1974000,Multnomah County,Multnomah County-San Luis Obispo County-CA
3336,Multnomah County-Oakland County-MI-2021,"Oakland County, MI",2021,2020,2021,55,3701000,69,4492000,-14,-791000,Multnomah County,Multnomah County-Oakland County-MI
3337,Multnomah County-Wake County-NC-2021,"Wake County, NC",2021,2020,2021,54,1434000,59,2522000,-5,-1088000,Multnomah County,Multnomah County-Wake County-NC
3338,Multnomah County-Solano County-CA-2021,"Solano County, CA",2021,2020,2021,59,2881000,40,1317000,19,1564000,Multnomah County,Multnomah County-Solano County-CA
3339,Multnomah County-Broward County-FL-2021,"Broward County, FL",2021,2020,2021,51,4328000,56,2997000,-5,1331000,Multnomah County,Multnomah County-Broward County-FL
3340,Multnomah County-Douglas County-NE-2021,"Douglas County, NE",2021,2020,2021,58,2665000,41,2326000,17,339000,Multnomah County,Multnomah County-Douglas County-NE
3341,Multnomah County-Mecklenburg County-NC-2021,"Mecklenburg County, NC",2021,2020,2021,59,2810000,71,4867000,-12,-2057000,Multnomah County,Multnomah County-Mecklenburg County-NC
3342,Multnomah County-Klamath County-OR-2021,"Klamath County, OR",2021,2020,2021,44,2250000,97,3168000,-53,-918000,Multnomah County,Multnomah County-Klamath County-OR
3343,Multnomah County-Baltimore city-MD-2021,"Baltimore city, MD",2021,2020,2021,45,2732000,51,3361000,-6,-629000,Multnomah County,Multnomah County-Baltimore city-MD
3344,Multnomah County-Gallatin County-MT-2021,"Gallatin County, MT",2021,2020,2021,46,1590000,78,3119000,-32,-1529000,Multnomah County,Multnomah County-Gallatin County-MT
3345,Multnomah County-Polk County-IA-2021,"Polk County, IA",2021,2020,2021,42,1517000,46,2307000,-4,-790000,Multnomah County,Multnomah County-Polk County-IA
3346,Multnomah County-St. Louis city-MO-2021,"St. Louis city, MO",2021,2020,2021,40,2774000,25,1031000,15,1743000,Multnomah County,Multnomah County-St. Louis city-MO
3347,Multnomah County-Duval County-FL-2021,"Duval County, FL",2021,2020,2021,37,1315000,104,3082000,-67,-1767000,Multnomah County,Multnomah County-Duval County-FL
3348,Multnomah County-Maui County-HI-2021,"Maui County, HI",2021,2020,2021,52,2144000,67,3027000,-15,-883000,Multnomah County,Multnomah County-Maui County-HI
3349,Multnomah County-Montgomery County-MD-2021,"Montgomery County, MD",2021,2020,2021,50,4270000,44,2557000,6,1713000,Multnomah County,Multnomah County-Montgomery County-MD
3350,Multnomah County-Wayne County-MI-2021,"Wayne County, MI",2021,2020,2021,36,1609000,41,1362000,-5,247000,Multnomah County,Multnomah County-Wayne County-MI
3351,Multnomah County-Fairfax County-VA-2021,"Fairfax County, VA",2021,2020,2021,39,3059000,38,1786000,1,1273000,Multnomah County,Multnomah County-Fairfax County-VA
3352,Multnomah County-Palm Beach County-FL-2021,"Palm Beach County, FL",2021,2020,2021,41,1355000,76,3899000,-35,-2544000,Multnomah County,Multnomah County-Palm Beach County-FL
3353,Multnomah County-Durham County-NC-2021,"Durham County, NC",2021,2020,2021,42,2243000,40,1896000,2,347000,Multnomah County,Multnomah County-Durham County-NC
3354,Multnomah County-Norfolk County-MA-2021,"Norfolk County, MA",2021,2020,2021,44,2753000,34,1971000,10,782000,Multnomah County,Multnomah County-Norfolk County-MA
3355,Multnomah County-Washtenaw County-MI-2021,"Washtenaw County, MI",2021,2020,2021,41,1591000,52,3591000,-11,-2000000,Multnomah County,Multnomah County-Washtenaw County-MI
3356,Multnomah County-Yakima County-WA-2021,"Yakima County, WA",2021,2020,2021,45,1195000,60,1554000,-15,-359000,Multnomah County,Multnomah County-Yakima County-WA
3357,Multnomah County-Hamilton County-OH-2021,"Hamilton County, OH",2021,2020,2021,35,1860000,29,1265000,6,595000,Multnomah County,Multnomah County-Hamilton County-OH
3358,Multnomah County-Yolo County-CA-2021,"Yolo County, CA",2021,2020,2021,32,1090000,29,1520000,3,-430000,Multnomah County,Multnomah County-Yolo County-CA
3359,Multnomah County-Monroe County-NY-2021,"Monroe County, NY",2021,2020,2021,47,2276000,41,1714000,6,562000,Multnomah County,Multnomah County-Monroe County-NY
3360,Multnomah County-Walla Walla County-WA-2021,"Walla Walla County, WA",2021,2020,2021,39,1213000,51,2184000,-12,-971000,Multnomah County,Multnomah County-Walla Walla County-WA
3361,Multnomah County-El Dorado County-CA-2021,"El Dorado County, CA",2021,2020,2021,34,1687000,31,1836000,3,-149000,Multnomah County,Multnomah County-El Dorado County-CA
3362,Multnomah County-Shasta County-CA-2021,"Shasta County, CA",2021,2020,2021,33,1374000,38,1703000,-5,-329000,Multnomah County,Multnomah County-Shasta County-CA
3363,Multnomah County-Fairfield County-CT-2021,"Fairfield County, CT",2021,2020,2021,35,1651000,46,3454000,-11,-1803000,Multnomah County,Multnomah County-Fairfield County-CT
3364,Multnomah County-St. Louis County-MO-2021,"St. Louis County, MO",2021,2020,2021,40,2123000,45,2249000,-5,-126000,Multnomah County,Multnomah County-St. Louis County-MO
3365,Multnomah County-Collin County-TX-2021,"Collin County, TX",2021,2020,2021,35,1324000,69,2984000,-34,-1660000,Multnomah County,Multnomah County-Collin County-TX
3366,Multnomah County-Denton County-TX-2021,"Denton County, TX",2021,2020,2021,41,2096000,75,2469000,-34,-373000,Multnomah County,Multnomah County-Denton County-TX
3367,Multnomah County-Hawaii County-HI-2021,"Hawaii County, HI",2021,2020,2021,38,1822000,110,3604000,-72,-1782000,Multnomah County,Multnomah County-Hawaii County-HI
3368,Multnomah County-Canyon County-ID-2021,"Canyon County, ID",2021,2020,2021,37,659000,101,3591000,-64,-2932000,Multnomah County,Multnomah County-Canyon County-ID
3369,Multnomah County-Cumberland County-ME-2021,"Cumberland County, ME",2021,2020,2021,31,1581000,50,2986000,-19,-1405000,Multnomah County,Multnomah County-Cumberland County-ME
3370,Multnomah County-Jefferson County-OR-2021,"Jefferson County, OR",2021,2020,2021,41,783000,83,2991000,-42,-2208000,Multnomah County,Multnomah County-Jefferson County-OR
3371,Multnomah County-Klickitat County-WA-2021,"Klickitat County, WA",2021,2020,2021,34,979000,122,9717000,-88,-8738000,Multnomah County,Multnomah County-Klickitat County-WA
3372,Multnomah County-Coconino County-AZ-2021,"Coconino County, AZ",2021,2020,2021,36,867000,28,1061000,8,-194000,Multnomah County,Multnomah County-Coconino County-AZ
3373,Multnomah County-Union County-OR-2021,"Union County, OR",2021,2020,2021,44,1267000,37,886000,7,381000,Multnomah County,Multnomah County-Union County-OR
3374,Multnomah County-Williamson County-TX-2021,"Williamson County, TX",2021,2020,2021,42,1825000,47,3030000,-5,-1205000,Multnomah County,Multnomah County-Williamson County-TX
3375,Multnomah County-Oklahoma County-OK-2021,"Oklahoma County, OK",2021,2020,2021,30,1285000,42,1044000,-12,241000,Multnomah County,Multnomah County-Oklahoma County-OK
3376,Multnomah County-Utah County-UT-2021,"Utah County, UT",2021,2020,2021,40,932000,72,2591000,-32,-1659000,Multnomah County,Multnomah County-Utah County-UT
3377,Multnomah County-Johnson County-KS-2021,"Johnson County, KS",2021,2020,2021,29,1486000,34,1402000,-5,84000,Multnomah County,Multnomah County-Johnson County-KS
3378,Multnomah County-Nevada County-CA-2021,"Nevada County, CA",2021,2020,2021,28,956000,35,1558000,-7,-602000,Multnomah County,Multnomah County-Nevada County-CA
3379,Multnomah County-DuPage County-IL-2021,"DuPage County, IL",2021,2020,2021,32,1562000,27,1105000,5,457000,Multnomah County,Multnomah County-DuPage County-IL
3380,Multnomah County-Kent County-MI-2021,"Kent County, MI",2021,2020,2021,33,1520000,40,1818000,-7,-298000,Multnomah County,Multnomah County-Kent County-MI
3381,Multnomah County-Buncombe County-NC-2021,"Buncombe County, NC",2021,2020,2021,22,560000,61,3205000,-39,-2645000,Multnomah County,Multnomah County-Buncombe County-NC
3382,Multnomah County-Pinal County-AZ-2021,"Pinal County, AZ",2021,2020,2021,31,973000,86,3203000,-55,-2230000,Multnomah County,Multnomah County-Pinal County-AZ
3383,Multnomah County-Kootenai County-ID-2021,"Kootenai County, ID",2021,2020,2021,35,931000,72,2856000,-37,-1925000,Multnomah County,Multnomah County-Kootenai County-ID
3384,Multnomah County-Yellowstone County-MT-2021,"Yellowstone County, MT",2021,2020,2021,26,839000,26,788000,0,51000,Multnomah County,Multnomah County-Yellowstone County-MT
3385,Multnomah County-Santa Fe County-NM-2021,"Santa Fe County, NM",2021,2020,2021,22,827000,42,2353000,-20,-1526000,Multnomah County,Multnomah County-Santa Fe County-NM
3386,Multnomah County-Chittenden County-VT-2021,"Chittenden County, VT",2021,2020,2021,22,1106000,48,2197000,-26,-1091000,Multnomah County,Multnomah County-Chittenden County-VT
3387,Multnomah County-Jefferson County-WA-2021,"Jefferson County, WA",2021,2020,2021,29,1032000,57,2574000,-28,-1542000,Multnomah County,Multnomah County-Jefferson County-WA
3388,Multnomah County-Skamania County-WA-2021,"Skamania County, WA",2021,2020,2021,27,1543000,104,5476000,-77,-3933000,Multnomah County,Multnomah County-Skamania County-WA
3390,Polk County-Marion County-OR-2021,"Marion County, OR",2021,2020,2021,2428,70066000,2208,63857000,220,6209000,Polk County,Polk County-Marion County-OR
3391,Polk County-Yamhill County-OR-2021,"Yamhill County, OR",2021,2020,2021,492,18027000,385,9979000,107,8048000,Polk County,Polk County-Yamhill County-OR
3392,Polk County-Washington County-OR-2021,"Washington County, OR",2021,2020,2021,274,10351000,230,7498000,44,2853000,Polk County,Polk County-Washington County-OR
3393,Polk County-Multnomah County-OR-2021,"Multnomah County, OR",2021,2020,2021,212,7310000,127,4491000,85,2819000,Polk County,Polk County-Multnomah County-OR
3394,Polk County-Linn County-OR-2021,"Linn County, OR",2021,2020,2021,233,6568000,283,8061000,-50,-1493000,Polk County,Polk County-Linn County-OR
3395,Polk County-Clackamas County-OR-2021,"Clackamas County, OR",2021,2020,2021,207,6977000,159,5025000,48,1952000,Polk County,Polk County-Clackamas County-OR
3396,Polk County-Benton County-OR-2021,"Benton County, OR",2021,2020,2021,204,6792000,162,5559000,42,1233000,Polk County,Polk County-Benton County-OR
3397,Polk County-Lane County-OR-2021,"Lane County, OR",2021,2020,2021,153,4560000,154,4694000,-1,-134000,Polk County,Polk County-Lane County-OR
3398,Polk County-Lincoln County-OR-2021,"Lincoln County, OR",2021,2020,2021,87,2104000,70,2617000,17,-513000,Polk County,Polk County-Lincoln County-OR
3399,Polk County-Deschutes County-OR-2021,"Deschutes County, OR",2021,2020,2021,69,2213000,97,4051000,-28,-1838000,Polk County,Polk County-Deschutes County-OR
3400,Polk County-Clark County-WA-2021,"Clark County, WA",2021,2020,2021,47,2257000,64,2790000,-17,-533000,Polk County,Polk County-Clark County-WA
3401,Polk County-Maricopa County-AZ-2021,"Maricopa County, AZ",2021,2020,2021,55,1798000,61,1758000,-6,40000,Polk County,Polk County-Maricopa County-AZ
3402,Polk County-Jackson County-OR-2021,"Jackson County, OR",2021,2020,2021,43,1608000,35,833000,8,775000,Polk County,Polk County-Jackson County-OR
3405,Tillamook County-Multnomah County-OR-2021,"Multnomah County, OR",2021,2020,2021,285,38605000,77,3212000,208,35393000,Tillamook County,Tillamook County-Multnomah County-OR
3406,Tillamook County-Washington County-OR-2021,"Washington County, OR",2021,2020,2021,221,14326000,132,3514000,89,10812000,Tillamook County,Tillamook County-Washington County-OR
3407,Tillamook County-Clackamas County-OR-2021,"Clackamas County, OR",2021,2020,2021,84,8696000,47,1994000,37,6702000,Tillamook County,Tillamook County-Clackamas County-OR
3408,Tillamook County-Marion County-OR-2021,"Marion County, OR",2021,2020,2021,58,1458000,45,760000,13,698000,Tillamook County,Tillamook County-Marion County-OR
3409,Tillamook County-Clatsop County-OR-2021,"Clatsop County, OR",2021,2020,2021,54,1913000,63,1914000,-9,-1000,Tillamook County,Tillamook County-Clatsop County-OR
3410,Tillamook County-Clark County-WA-2021,"Clark County, WA",2021,2020,2021,55,1263000,42,1480000,13,-217000,Tillamook County,Tillamook County-Clark County-WA
3411,Tillamook County-Yamhill County-OR-2021,"Yamhill County, OR",2021,2020,2021,40,1219000,39,1121000,1,98000,Tillamook County,Tillamook County-Yamhill County-OR
3412,Tillamook County-Lane County-OR-2021,"Lane County, OR",2021,2020,2021,47,1226000,29,1525000,18,-299000,Tillamook County,Tillamook County-Lane County-OR
3413,Tillamook County-Lincoln County-OR-2021,"Lincoln County, OR",2021,2020,2021,31,1217000,66,1741000,-35,-524000,Tillamook County,Tillamook County-Lincoln County-OR
3415,Umatilla County-Morrow County-OR-2021,"Morrow County, OR",2021,2020,2021,254,5609000,279,7216000,-25,-1607000,Umatilla County,Umatilla County-Morrow County-OR
3416,Umatilla County-Walla Walla County-WA-2021,"Walla Walla County, WA",2021,2020,2021,286,5660000,359,9393000,-73,-3733000,Umatilla County,Umatilla County-Walla Walla County-WA
3417,Umatilla County-Benton County-WA-2021,"Benton County, WA",2021,2020,2021,213,5305000,268,7800000,-55,-2495000,Umatilla County,Umatilla County-Benton County-WA
3418,Umatilla County-Marion County-OR-2021,"Marion County, OR",2021,2020,2021,119,2137000,284,1175000,-165,962000,Umatilla County,Umatilla County-Marion County-OR
3419,Umatilla County-Multnomah County-OR-2021,"Multnomah County, OR",2021,2020,2021,114,2689000,79,3615000,35,-926000,Umatilla County,Umatilla County-Multnomah County-OR
3420,Umatilla County-Franklin County-WA-2021,"Franklin County, WA",2021,2020,2021,112,2030000,61,1409000,51,621000,Umatilla County,Umatilla County-Franklin County-WA
3421,Umatilla County-Union County-OR-2021,"Union County, OR",2021,2020,2021,78,1726000,90,2242000,-12,-516000,Umatilla County,Umatilla County-Union County-OR
3422,Umatilla County-Washington County-OR-2021,"Washington County, OR",2021,2020,2021,76,1868000,59,1957000,17,-89000,Umatilla County,Umatilla County-Washington County-OR
3423,Umatilla County-Deschutes County-OR-2021,"Deschutes County, OR",2021,2020,2021,65,1443000,39,1535000,26,-92000,Umatilla County,Umatilla County-Deschutes County-OR
3424,Umatilla County-Clackamas County-OR-2021,"Clackamas County, OR",2021,2020,2021,67,2240000,31,683000,36,1557000,Umatilla County,Umatilla County-Clackamas County-OR
3425,Umatilla County-Lane County-OR-2021,"Lane County, OR",2021,2020,2021,54,607000,45,1504000,9,-897000,Umatilla County,Umatilla County-Lane County-OR
3426,Umatilla County-Spokane County-WA-2021,"Spokane County, WA",2021,2020,2021,42,1148000,30,1237000,12,-89000,Umatilla County,Umatilla County-Spokane County-WA
3427,Umatilla County-Yakima County-WA-2021,"Yakima County, WA",2021,2020,2021,38,839000,51,817000,-13,22000,Umatilla County,Umatilla County-Yakima County-WA
3429,Union County-Baker County-OR-2021,"Baker County, OR",2021,2020,2021,110,2389000,79,1775000,31,614000,Union County,Union County-Baker County-OR
3430,Union County-Umatilla County-OR-2021,"Umatilla County, OR",2021,2020,2021,90,2242000,78,1726000,12,516000,Union County,Union County-Umatilla County-OR
3431,Union County-Ada County-ID-2021,"Ada County, ID",2021,2020,2021,42,1352000,40,1111000,2,241000,Union County,Union County-Ada County-ID
3432,Union County-Multnomah County-OR-2021,"Multnomah County, OR",2021,2020,2021,37,886000,44,1267000,-7,-381000,Union County,Union County-Multnomah County-OR
3435,Wasco County-Hood River County-OR-2021,"Hood River County, OR",2021,2020,2021,248,6870000,119,3913000,129,2957000,Wasco County,Wasco County-Hood River County-OR
3436,Wasco County-Multnomah County-OR-2021,"Multnomah County, OR",2021,2020,2021,126,6181000,84,2287000,42,3894000,Wasco County,Wasco County-Multnomah County-OR
3437,Wasco County-Klickitat County-WA-2021,"Klickitat County, WA",2021,2020,2021,124,3097000,159,4902000,-35,-1805000,Wasco County,Wasco County-Klickitat County-WA
3438,Wasco County-Clackamas County-OR-2021,"Clackamas County, OR",2021,2020,2021,70,1516000,73,1828000,-3,-312000,Wasco County,Wasco County-Clackamas County-OR
3439,Wasco County-Washington County-OR-2021,"Washington County, OR",2021,2020,2021,44,2439000,37,1083000,7,1356000,Wasco County,Wasco County-Washington County-OR
3440,Wasco County-Clark County-WA-2021,"Clark County, WA",2021,2020,2021,36,1087000,41,1260000,-5,-173000,Wasco County,Wasco County-Clark County-WA
3442,Washington County-Multnomah County-OR-2021,"Multnomah County, OR",2021,2020,2021,8058,449518000,5956,349406000,2102,100112000,Washington County,Washington County-Multnomah County-OR
3443,Washington County-Clackamas County-OR-2021,"Clackamas County, OR",2021,2020,2021,3327,140925000,3714,252516000,-387,-111591000,Washington County,Washington County-Clackamas County-OR
3444,Washington County-Clark County-WA-2021,"Clark County, WA",2021,2020,2021,1055,40828000,2103,119173000,-1048,-78345000,Washington County,Washington County-Clark County-WA
3445,Washington County-Marion County-OR-2021,"Marion County, OR",2021,2020,2021,964,27495000,1534,48869000,-570,-21374000,Washington County,Washington County-Marion County-OR
3446,Washington County-Yamhill County-OR-2021,"Yamhill County, OR",2021,2020,2021,972,35048000,1765,75658000,-793,-40610000,Washington County,Washington County-Yamhill County-OR
3447,Washington County-Los Angeles County-CA-2021,"Los Angeles County, CA",2021,2020,2021,869,44927000,394,20917000,475,24010000,Washington County,Washington County-Los Angeles County-CA
3448,Washington County-King County-WA-2021,"King County, WA",2021,2020,2021,621,48160000,801,60815000,-180,-12655000,Washington County,Washington County-King County-WA
3449,Washington County-Maricopa County-AZ-2021,"Maricopa County, AZ",2021,2020,2021,652,29902000,1056,66399000,-404,-36497000,Washington County,Washington County-Maricopa County-AZ
3450,Washington County-Lane County-OR-2021,"Lane County, OR",2021,2020,2021,489,15508000,454,18284000,35,-2776000,Washington County,Washington County-Lane County-OR
3451,Washington County-Santa Clara County-CA-2021,"Santa Clara County, CA",2021,2020,2021,580,54195000,346,32170000,234,22025000,Washington County,Washington County-Santa Clara County-CA
3452,Washington County-San Diego County-CA-2021,"San Diego County, CA",2021,2020,2021,435,19291000,334,18103000,101,1188000,Washington County,Washington County-San Diego County-CA
3453,Washington County-Orange County-CA-2021,"Orange County, CA",2021,2020,2021,382,16356000,192,9712000,190,6644000,Washington County,Washington County-Orange County-CA
3454,Washington County-Columbia County-OR-2021,"Columbia County, OR",2021,2020,2021,378,11787000,929,32454000,-551,-20667000,Washington County,Washington County-Columbia County-OR
3455,Washington County-Benton County-OR-2021,"Benton County, OR",2021,2020,2021,284,10313000,214,7268000,70,3045000,Washington County,Washington County-Benton County-OR
3456,Washington County-Deschutes County-OR-2021,"Deschutes County, OR",2021,2020,2021,294,12585000,750,81159000,-456,-68574000,Washington County,Washington County-Deschutes County-OR
3457,Washington County-Clark County-NV-2021,"Clark County, NV",2021,2020,2021,305,9542000,296,13381000,9,-3839000,Washington County,Washington County-Clark County-NV
3458,Washington County-Alameda County-CA-2021,"Alameda County, CA",2021,2020,2021,309,20876000,152,9566000,157,11310000,Washington County,Washington County-Alameda County-CA
3459,Washington County-Polk County-OR-2021,"Polk County, OR",2021,2020,2021,230,7498000,274,10351000,-44,-2853000,Washington County,Washington County-Polk County-OR
3460,Washington County-Jackson County-OR-2021,"Jackson County, OR",2021,2020,2021,190,7569000,196,7055000,-6,514000,Washington County,Washington County-Jackson County-OR
3461,Washington County-Honolulu County-HI-2021,"Honolulu County, HI",2021,2020,2021,249,7761000,140,9823000,109,-2062000,Washington County,Washington County-Honolulu County-HI
3462,Washington County-Riverside County-CA-2021,"Riverside County, CA",2021,2020,2021,205,7276000,135,7517000,70,-241000,Washington County,Washington County-Riverside County-CA
3463,Washington County-Sacramento County-CA-2021,"Sacramento County, CA",2021,2020,2021,177,8025000,100,4291000,77,3734000,Washington County,Washington County-Sacramento County-CA
3464,Washington County-Pierce County-WA-2021,"Pierce County, WA",2021,2020,2021,179,7322000,208,8540000,-29,-1218000,Washington County,Washington County-Pierce County-WA
3465,Washington County-Salt Lake County-UT-2021,"Salt Lake County, UT",2021,2020,2021,180,6504000,165,6648000,15,-144000,Washington County,Washington County-Salt Lake County-UT
3466,Washington County-Contra Costa County-CA-2021,"Contra Costa County, CA",2021,2020,2021,181,10184000,43,2753000,138,7431000,Washington County,Washington County-Contra Costa County-CA
3467,Washington County-Linn County-OR-2021,"Linn County, OR",2021,2020,2021,140,4806000,222,8586000,-82,-3780000,Washington County,Washington County-Linn County-OR
3468,Washington County-San Francisco County-CA-2021,"San Francisco County, CA",2021,2020,2021,141,16866000,66,6232000,75,10634000,Washington County,Washington County-San Francisco County-CA
3469,Washington County-Ada County-ID-2021,"Ada County, ID",2021,2020,2021,158,6975000,366,17921000,-208,-10946000,Washington County,Washington County-Ada County-ID
3470,Washington County-Snohomish County-WA-2021,"Snohomish County, WA",2021,2020,2021,157,5471000,203,12933000,-46,-7462000,Washington County,Washington County-Snohomish County-WA
3471,Washington County-Clatsop County-OR-2021,"Clatsop County, OR",2021,2020,2021,137,4456000,209,14953000,-72,-10497000,Washington County,Washington County-Clatsop County-OR
3472,Washington County-San Bernardino County-CA-2021,"San Bernardino County, CA",2021,2020,2021,156,3835000,82,1689000,74,2146000,Washington County,Washington County-San Bernardino County-CA
3473,Washington County-Travis County-TX-2021,"Travis County, TX",2021,2020,2021,128,6840000,226,17806000,-98,-10966000,Washington County,Washington County-Travis County-TX
3474,Washington County-Tillamook County-OR-2021,"Tillamook County, OR",2021,2020,2021,132,3514000,221,14326000,-89,-10812000,Washington County,Washington County-Tillamook County-OR
3475,Washington County-San Mateo County-CA-2021,"San Mateo County, CA",2021,2020,2021,130,7857000,56,4031000,74,3826000,Washington County,Washington County-San Mateo County-CA
3476,Washington County-Spokane County-WA-2021,"Spokane County, WA",2021,2020,2021,131,4051000,152,7374000,-21,-3323000,Washington County,Washington County-Spokane County-WA
3477,Washington County-Lincoln County-OR-2021,"Lincoln County, OR",2021,2020,2021,120,3344000,158,7660000,-38,-4316000,Washington County,Washington County-Lincoln County-OR
3478,Washington County-Cook County-IL-2021,"Cook County, IL",2021,2020,2021,118,6173000,79,6239000,39,-66000,Washington County,Washington County-Cook County-IL
3479,Washington County-Pima County-AZ-2021,"Pima County, AZ",2021,2020,2021,85,2879000,143,6989000,-58,-4110000,Washington County,Washington County-Pima County-AZ
3480,Washington County-Ventura County-CA-2021,"Ventura County, CA",2021,2020,2021,95,4222000,74,2008000,21,2214000,Washington County,Washington County-Ventura County-CA
3481,Washington County-Harris County-TX-2021,"Harris County, TX",2021,2020,2021,98,4556000,156,7989000,-58,-3433000,Washington County,Washington County-Harris County-TX
3482,Washington County-Hennepin County-MN-2021,"Hennepin County, MN",2021,2020,2021,86,6214000,62,2712000,24,3502000,Washington County,Washington County-Hennepin County-MN
3483,Washington County-Thurston County-WA-2021,"Thurston County, WA",2021,2020,2021,106,3577000,100,4704000,6,-1127000,Washington County,Washington County-Thurston County-WA
3484,Washington County-Cowlitz County-WA-2021,"Cowlitz County, WA",2021,2020,2021,88,2395000,173,6713000,-85,-4318000,Washington County,Washington County-Cowlitz County-WA
3485,Washington County-Dallas County-TX-2021,"Dallas County, TX",2021,2020,2021,94,4484000,133,7565000,-39,-3081000,Washington County,Washington County-Dallas County-TX
3486,Washington County-Utah County-UT-2021,"Utah County, UT",2021,2020,2021,105,3972000,171,5347000,-66,-1375000,Washington County,Washington County-Utah County-UT
3487,Washington County-Denver County-CO-2021,"Denver County, CO",2021,2020,2021,82,4760000,72,3976000,10,784000,Washington County,Washington County-Denver County-CO
3488,Washington County-Bernalillo County-NM-2021,"Bernalillo County, NM",2021,2020,2021,83,4240000,59,3117000,24,1123000,Washington County,Washington County-Bernalillo County-NM
3489,Washington County-Douglas County-OR-2021,"Douglas County, OR",2021,2020,2021,91,2083000,130,4689000,-39,-2606000,Washington County,Washington County-Douglas County-OR
3490,Washington County-Sonoma County-CA-2021,"Sonoma County, CA",2021,2020,2021,77,3597000,34,2204000,43,1393000,Washington County,Washington County-Sonoma County-CA
3491,Washington County-Kings County-NY-2021,"Kings County, NY",2021,2020,2021,70,4358000,30,2148000,40,2210000,Washington County,Washington County-Kings County-NY
3492,Washington County-Josephine County-OR-2021,"Josephine County, OR",2021,2020,2021,88,2676000,50,1446000,38,1230000,Washington County,Washington County-Josephine County-OR
3493,Washington County-Benton County-WA-2021,"Benton County, WA",2021,2020,2021,67,2498000,92,3782000,-25,-1284000,Washington County,Washington County-Benton County-WA
3494,Washington County-Washoe County-NV-2021,"Washoe County, NV",2021,2020,2021,69,2219000,71,3653000,-2,-1434000,Washington County,Washington County-Washoe County-NV
3495,Washington County-Coos County-OR-2021,"Coos County, OR",2021,2020,2021,66,1980000,77,2751000,-11,-771000,Washington County,Washington County-Coos County-OR
3496,Washington County-Klamath County-OR-2021,"Klamath County, OR",2021,2020,2021,70,1609000,77,2888000,-7,-1279000,Washington County,Washington County-Klamath County-OR
3497,Washington County-New York County-NY-2021,"New York County, NY",2021,2020,2021,53,5954000,33,2955000,20,2999000,Washington County,Washington County-New York County-NY
3498,Washington County-Umatilla County-OR-2021,"Umatilla County, OR",2021,2020,2021,59,1957000,76,1868000,-17,89000,Washington County,Washington County-Umatilla County-OR
3499,Washington County-Collin County-TX-2021,"Collin County, TX",2021,2020,2021,61,3785000,258,13821000,-197,-10036000,Washington County,Washington County-Collin County-TX
3500,Washington County-Placer County-CA-2021,"Placer County, CA",2021,2020,2021,59,2397000,47,1514000,12,883000,Washington County,Washington County-Placer County-CA
3501,Washington County-Larimer County-CO-2021,"Larimer County, CO",2021,2020,2021,47,2140000,45,2399000,2,-259000,Washington County,Washington County-Larimer County-CO
3502,Washington County-Middlesex County-MA-2021,"Middlesex County, MA",2021,2020,2021,77,5504000,55,3289000,22,2215000,Washington County,Washington County-Middlesex County-MA
3503,Washington County-Maui County-HI-2021,"Maui County, HI",2021,2020,2021,54,1672000,29,1009000,25,663000,Washington County,Washington County-Maui County-HI
3504,Washington County-Anchorage Municipality-AK-2021,"Anchorage Municipality, AK",2021,2020,2021,62,2891000,57,2858000,5,33000,Washington County,Washington County-Anchorage Municipality-AK
3505,Washington County-Tarrant County-TX-2021,"Tarrant County, TX",2021,2020,2021,72,2637000,124,4169000,-52,-1532000,Washington County,Washington County-Tarrant County-TX
3506,Washington County-El Paso County-CO-2021,"El Paso County, CO",2021,2020,2021,67,1886000,74,2306000,-7,-420000,Washington County,Washington County-El Paso County-CO
3507,Washington County-Bexar County-TX-2021,"Bexar County, TX",2021,2020,2021,64,1682000,150,6218000,-86,-4536000,Washington County,Washington County-Bexar County-TX
3508,Washington County-Denton County-TX-2021,"Denton County, TX",2021,2020,2021,54,1625000,125,8521000,-71,-6896000,Washington County,Washington County-Denton County-TX
3509,Washington County-Yakima County-WA-2021,"Yakima County, WA",2021,2020,2021,50,1298000,42,1261000,8,37000,Washington County,Washington County-Yakima County-WA
3510,Washington County-Arapahoe County-CO-2021,"Arapahoe County, CO",2021,2020,2021,56,1810000,37,1895000,19,-85000,Washington County,Washington County-Arapahoe County-CO
3511,Washington County-Hood River County-OR-2021,"Hood River County, OR",2021,2020,2021,51,1820000,60,3628000,-9,-1808000,Washington County,Washington County-Hood River County-OR
3512,Washington County-San Joaquin County-CA-2021,"San Joaquin County, CA",2021,2020,2021,55,2835000,33,1158000,22,1677000,Washington County,Washington County-San Joaquin County-CA
3513,Washington County-Stanislaus County-CA-2021,"Stanislaus County, CA",2021,2020,2021,43,1487000,33,913000,10,574000,Washington County,Washington County-Stanislaus County-CA
3514,Washington County-Franklin County-OH-2021,"Franklin County, OH",2021,2020,2021,50,2201000,35,1548000,15,653000,Washington County,Washington County-Franklin County-OH
3515,Washington County-Jefferson County-CO-2021,"Jefferson County, CO",2021,2020,2021,54,3182000,37,2007000,17,1175000,Washington County,Washington County-Jefferson County-CO
3516,Washington County-Fairfax County-VA-2021,"Fairfax County, VA",2021,2020,2021,51,2133000,37,2049000,14,84000,Washington County,Washington County-Fairfax County-VA
3517,Washington County-Hillsborough County-FL-2021,"Hillsborough County, FL",2021,2020,2021,38,1609000,73,2667000,-35,-1058000,Washington County,Washington County-Hillsborough County-FL
3518,Washington County-Orange County-FL-2021,"Orange County, FL",2021,2020,2021,43,1286000,64,2810000,-21,-1524000,Washington County,Washington County-Orange County-FL
3519,Washington County-Fulton County-GA-2021,"Fulton County, GA",2021,2020,2021,41,1500000,49,3027000,-8,-1527000,Washington County,Washington County-Fulton County-GA
3520,Washington County-Davidson County-TN-2021,"Davidson County, TN",2021,2020,2021,38,1491000,40,1252000,-2,239000,Washington County,Washington County-Davidson County-TN
3521,Washington County-Kitsap County-WA-2021,"Kitsap County, WA",2021,2020,2021,46,1904000,83,4815000,-37,-2911000,Washington County,Washington County-Kitsap County-WA
3522,Washington County-Whatcom County-WA-2021,"Whatcom County, WA",2021,2020,2021,37,1175000,55,2262000,-18,-1087000,Washington County,Washington County-Whatcom County-WA
3523,Washington County-Hawaii County-HI-2021,"Hawaii County, HI",2021,2020,2021,36,1406000,67,2773000,-31,-1367000,Washington County,Washington County-Hawaii County-HI
3524,Washington County-Wasco County-OR-2021,"Wasco County, OR",2021,2020,2021,37,1083000,44,2439000,-7,-1356000,Washington County,Washington County-Wasco County-OR
3525,Washington County-Wake County-NC-2021,"Wake County, NC",2021,2020,2021,31,1568000,74,3431000,-43,-1863000,Washington County,Washington County-Wake County-NC
3526,Washington County-Williamson County-TX-2021,"Williamson County, TX",2021,2020,2021,52,2504000,197,12095000,-145,-9591000,Washington County,Washington County-Williamson County-TX
3527,Washington County-Solano County-CA-2021,"Solano County, CA",2021,2020,2021,42,857000,34,1358000,8,-501000,Washington County,Washington County-Solano County-CA
3528,Washington County-Jefferson County-OR-2021,"Jefferson County, OR",2021,2020,2021,33,561000,51,2079000,-18,-1518000,Washington County,Washington County-Jefferson County-OR
3529,Washington County-Broward County-FL-2021,"Broward County, FL",2021,2020,2021,37,1864000,44,2276000,-7,-412000,Washington County,Washington County-Broward County-FL
3530,Washington County-Miami-Dade County-FL-2021,"Miami-Dade County, FL",2021,2020,2021,36,1046000,43,1723000,-7,-677000,Washington County,Washington County-Miami-Dade County-FL
3531,Washington County-Pinal County-AZ-2021,"Pinal County, AZ",2021,2020,2021,36,983000,171,6362000,-135,-5379000,Washington County,Washington County-Pinal County-AZ
3532,Washington County-Canyon County-ID-2021,"Canyon County, ID",2021,2020,2021,32,823000,117,4845000,-85,-4022000,Washington County,Washington County-Canyon County-ID
3535,Yamhill County-Washington County-OR-2021,"Washington County, OR",2021,2020,2021,1765,75658000,972,35048000,793,40610000,Yamhill County,Yamhill County-Washington County-OR
3536,Yamhill County-Multnomah County-OR-2021,"Multnomah County, OR",2021,2020,2021,503,23330000,294,7757000,209,15573000,Yamhill County,Yamhill County-Multnomah County-OR
3537,Yamhill County-Clackamas County-OR-2021,"Clackamas County, OR",2021,2020,2021,555,29543000,346,14826000,209,14717000,Yamhill County,Yamhill County-Clackamas County-OR
3538,Yamhill County-Marion County-OR-2021,"Marion County, OR",2021,2020,2021,420,11865000,522,12872000,-102,-1007000,Yamhill County,Yamhill County-Marion County-OR
3539,Yamhill County-Polk County-OR-2021,"Polk County, OR",2021,2020,2021,385,9979000,492,18027000,-107,-8048000,Yamhill County,Yamhill County-Polk County-OR
3540,Yamhill County-Deschutes County-OR-2021,"Deschutes County, OR",2021,2020,2021,86,3281000,144,6550000,-58,-3269000,Yamhill County,Yamhill County-Deschutes County-OR
3541,Yamhill County-Lane County-OR-2021,"Lane County, OR",2021,2020,2021,82,2341000,76,3211000,6,-870000,Yamhill County,Yamhill County-Lane County-OR
3542,Yamhill County-Clark County-WA-2021,"Clark County, WA",2021,2020,2021,84,3092000,110,4482000,-26,-1390000,Yamhill County,Yamhill County-Clark County-WA
3543,Yamhill County-Los Angeles County-CA-2021,"Los Angeles County, CA",2021,2020,2021,66,2802000,28,1239000,38,1563000,Yamhill County,Yamhill County-Los Angeles County-CA
3544,Yamhill County-Linn County-OR-2021,"Linn County, OR",2021,2020,2021,67,1871000,103,2374000,-36,-503000,Yamhill County,Yamhill County-Linn County-OR
3545,Yamhill County-Benton County-OR-2021,"Benton County, OR",2021,2020,2021,52,2060000,85,2313000,-33,-253000,Yamhill County,Yamhill County-Benton County-OR
3546,Yamhill County-Maricopa County-AZ-2021,"Maricopa County, AZ",2021,2020,2021,53,2117000,86,4260000,-33,-2143000,Yamhill County,Yamhill County-Maricopa County-AZ
3547,Yamhill County-Lincoln County-OR-2021,"Lincoln County, OR",2021,2020,2021,54,1843000,87,2321000,-33,-478000,Yamhill County,Yamhill County-Lincoln County-OR
3548,Yamhill County-King County-WA-2021,"King County, WA",2021,2020,2021,42,3029000,42,3341000,0,-312000,Yamhill County,Yamhill County-King County-WA
3549,Yamhill County-Jackson County-OR-2021,"Jackson County, OR",2021,2020,2021,41,811000,44,1005000,-3,-194000,Yamhill County,Yamhill County-Jackson County-OR
3550,Yamhill County-Tillamook County-OR-2021,"Tillamook County, OR",2021,2020,2021,39,1121000,40,1219000,-1,-98000,Yamhill County,Yamhill County-Tillamook County-OR
3552,Baker County-Union County-OR-1516,"Union County, OR",1516,2015,2016,109,1655000,93,1284000,16,371000,Baker County,Baker County-Union County-OR
3553,Baker County-Ada County-ID-1516,"Ada County, ID",1516,2015,2016,54,1016000,44,1383000,10,-367000,Baker County,Baker County-Ada County-ID
3555,Benton County-Linn County-OR-1516,"Linn County, OR",1516,2015,2016,888,22853000,1302,32200000,-414,-9347000,Benton County,Benton County-Linn County-OR
3556,Benton County-Lane County-OR-1516,"Lane County, OR",1516,2015,2016,360,8218000,352,9018000,8,-800000,Benton County,Benton County-Lane County-OR
3557,Benton County-Multnomah County-OR-1516,"Multnomah County, OR",1516,2015,2016,249,6611000,331,10217000,-82,-3606000,Benton County,Benton County-Multnomah County-OR
3558,Benton County-Marion County-OR-1516,"Marion County, OR",1516,2015,2016,217,6184000,309,7653000,-92,-1469000,Benton County,Benton County-Marion County-OR
3559,Benton County-Washington County-OR-1516,"Washington County, OR",1516,2015,2016,162,3823000,293,8249000,-131,-4426000,Benton County,Benton County-Washington County-OR
3560,Benton County-Clackamas County-OR-1516,"Clackamas County, OR",1516,2015,2016,148,4090000,151,5059000,-3,-969000,Benton County,Benton County-Clackamas County-OR
3561,Benton County-Polk County-OR-1516,"Polk County, OR",1516,2015,2016,143,3627000,154,4810000,-11,-1183000,Benton County,Benton County-Polk County-OR
3562,Benton County-Lincoln County-OR-1516,"Lincoln County, OR",1516,2015,2016,126,3732000,119,3482000,7,250000,Benton County,Benton County-Lincoln County-OR
3563,Benton County-Deschutes County-OR-1516,"Deschutes County, OR",1516,2015,2016,86,2238000,162,5674000,-76,-3436000,Benton County,Benton County-Deschutes County-OR
3564,Benton County-Los Angeles County-CA-1516,"Los Angeles County, CA",1516,2015,2016,83,4112000,28,910000,55,3202000,Benton County,Benton County-Los Angeles County-CA
3565,Benton County-Jackson County-OR-1516,"Jackson County, OR",1516,2015,2016,59,1436000,74,1778000,-15,-342000,Benton County,Benton County-Jackson County-OR
3566,Benton County-King County-WA-1516,"King County, WA",1516,2015,2016,57,2384000,138,4686000,-81,-2302000,Benton County,Benton County-King County-WA
3567,Benton County-San Diego County-CA-1516,"San Diego County, CA",1516,2015,2016,57,1932000,56,1159000,1,773000,Benton County,Benton County-San Diego County-CA
3568,Benton County-Maricopa County-AZ-1516,"Maricopa County, AZ",1516,2015,2016,52,2646000,42,1933000,10,713000,Benton County,Benton County-Maricopa County-AZ
3569,Benton County-Yamhill County-OR-1516,"Yamhill County, OR",1516,2015,2016,36,596000,51,1412000,-15,-816000,Benton County,Benton County-Yamhill County-OR
3570,Benton County-Alameda County-CA-1516,"Alameda County, CA",1516,2015,2016,53,2174000,29,933000,24,1241000,Benton County,Benton County-Alameda County-CA
3571,Benton County-Santa Clara County-CA-1516,"Santa Clara County, CA",1516,2015,2016,41,2502000,43,1579000,-2,923000,Benton County,Benton County-Santa Clara County-CA
3573,Clackamas County-Multnomah County-OR-1516,"Multnomah County, OR",1516,2015,2016,10215,352085000,6347,197377000,3868,154708000,Clackamas County,Clackamas County-Multnomah County-OR
3574,Clackamas County-Washington County-OR-1516,"Washington County, OR",1516,2015,2016,4079,195470000,3397,132835000,682,62635000,Clackamas County,Clackamas County-Washington County-OR
3575,Clackamas County-Marion County-OR-1516,"Marion County, OR",1516,2015,2016,1167,35079000,1849,47839000,-682,-12760000,Clackamas County,Clackamas County-Marion County-OR
3576,Clackamas County-Clark County-WA-1516,"Clark County, WA",1516,2015,2016,1057,31433000,1700,59522000,-643,-28089000,Clackamas County,Clackamas County-Clark County-WA
3577,Clackamas County-Los Angeles County-CA-1516,"Los Angeles County, CA",1516,2015,2016,513,25597000,135,4643000,378,20954000,Clackamas County,Clackamas County-Los Angeles County-CA
3578,Clackamas County-Lane County-OR-1516,"Lane County, OR",1516,2015,2016,346,13835000,293,7899000,53,5936000,Clackamas County,Clackamas County-Lane County-OR
3579,Clackamas County-Yamhill County-OR-1516,"Yamhill County, OR",1516,2015,2016,357,12186000,445,12484000,-88,-298000,Clackamas County,Clackamas County-Yamhill County-OR
3580,Clackamas County-King County-WA-1516,"King County, WA",1516,2015,2016,299,15501000,309,14651000,-10,850000,Clackamas County,Clackamas County-King County-WA
3581,Clackamas County-Deschutes County-OR-1516,"Deschutes County, OR",1516,2015,2016,267,8515000,494,25474000,-227,-16959000,Clackamas County,Clackamas County-Deschutes County-OR
3582,Clackamas County-Maricopa County-AZ-1516,"Maricopa County, AZ",1516,2015,2016,277,12343000,319,13316000,-42,-973000,Clackamas County,Clackamas County-Maricopa County-AZ
3583,Clackamas County-San Diego County-CA-1516,"San Diego County, CA",1516,2015,2016,288,10617000,129,6190000,159,4427000,Clackamas County,Clackamas County-San Diego County-CA
3584,Clackamas County-Jackson County-OR-1516,"Jackson County, OR",1516,2015,2016,224,9631000,127,2845000,97,6786000,Clackamas County,Clackamas County-Jackson County-OR
3585,Clackamas County-Benton County-OR-1516,"Benton County, OR",1516,2015,2016,151,5059000,148,4090000,3,969000,Clackamas County,Clackamas County-Benton County-OR
3586,Clackamas County-Santa Clara County-CA-1516,"Santa Clara County, CA",1516,2015,2016,250,20791000,47,3079000,203,17712000,Clackamas County,Clackamas County-Santa Clara County-CA
3587,Clackamas County-Orange County-CA-1516,"Orange County, CA",1516,2015,2016,197,8174000,112,10894000,85,-2720000,Clackamas County,Clackamas County-Orange County-CA
3588,Clackamas County-Clark County-NV-1516,"Clark County, NV",1516,2015,2016,196,4991000,112,6185000,84,-1194000,Clackamas County,Clackamas County-Clark County-NV
3589,Clackamas County-Pierce County-WA-1516,"Pierce County, WA",1516,2015,2016,153,5567000,135,4062000,18,1505000,Clackamas County,Clackamas County-Pierce County-WA
3590,Clackamas County-Alameda County-CA-1516,"Alameda County, CA",1516,2015,2016,161,8222000,51,2273000,110,5949000,Clackamas County,Clackamas County-Alameda County-CA
3591,Clackamas County-Linn County-OR-1516,"Linn County, OR",1516,2015,2016,102,2933000,157,4902000,-55,-1969000,Clackamas County,Clackamas County-Linn County-OR
3592,Clackamas County-Polk County-OR-1516,"Polk County, OR",1516,2015,2016,121,3777000,163,5200000,-42,-1423000,Clackamas County,Clackamas County-Polk County-OR
3593,Clackamas County-Lincoln County-OR-1516,"Lincoln County, OR",1516,2015,2016,82,2417000,139,4392000,-57,-1975000,Clackamas County,Clackamas County-Lincoln County-OR
3594,Clackamas County-Riverside County-CA-1516,"Riverside County, CA",1516,2015,2016,100,2709000,102,3793000,-2,-1084000,Clackamas County,Clackamas County-Riverside County-CA
3595,Clackamas County-Travis County-TX-1516,"Travis County, TX",1516,2015,2016,97,4020000,41,1332000,56,2688000,Clackamas County,Clackamas County-Travis County-TX
3596,Clackamas County-Columbia County-OR-1516,"Columbia County, OR",1516,2015,2016,77,4835000,172,4419000,-95,416000,Clackamas County,Clackamas County-Columbia County-OR
3597,Clackamas County-Salt Lake County-UT-1516,"Salt Lake County, UT",1516,2015,2016,100,3478000,53,1789000,47,1689000,Clackamas County,Clackamas County-Salt Lake County-UT
3598,Clackamas County-San Bernardino County-CA-1516,"San Bernardino County, CA",1516,2015,2016,100,2848000,43,1002000,57,1846000,Clackamas County,Clackamas County-San Bernardino County-CA
3599,Clackamas County-San Francisco County-CA-1516,"San Francisco County, CA",1516,2015,2016,97,7004000,22,1131000,75,5873000,Clackamas County,Clackamas County-San Francisco County-CA
3600,Clackamas County-Honolulu County-HI-1516,"Honolulu County, HI",1516,2015,2016,110,3159000,55,1522000,55,1637000,Clackamas County,Clackamas County-Honolulu County-HI
3601,Clackamas County-Contra Costa County-CA-1516,"Contra Costa County, CA",1516,2015,2016,98,7134000,43,1713000,55,5421000,Clackamas County,Clackamas County-Contra Costa County-CA
3602,Clackamas County-Sacramento County-CA-1516,"Sacramento County, CA",1516,2015,2016,86,4267000,57,2355000,29,1912000,Clackamas County,Clackamas County-Sacramento County-CA
3603,Clackamas County-Clatsop County-OR-1516,"Clatsop County, OR",1516,2015,2016,82,2607000,100,3216000,-18,-609000,Clackamas County,Clackamas County-Clatsop County-OR
3604,Clackamas County-Snohomish County-WA-1516,"Snohomish County, WA",1516,2015,2016,76,2230000,120,5102000,-44,-2872000,Clackamas County,Clackamas County-Snohomish County-WA
3605,Clackamas County-Spokane County-WA-1516,"Spokane County, WA",1516,2015,2016,88,2652000,102,3365000,-14,-713000,Clackamas County,Clackamas County-Spokane County-WA
3606,Clackamas County-Pima County-AZ-1516,"Pima County, AZ",1516,2015,2016,74,2109000,43,1551000,31,558000,Clackamas County,Clackamas County-Pima County-AZ
3607,Clackamas County-Thurston County-WA-1516,"Thurston County, WA",1516,2015,2016,75,2662000,57,1498000,18,1164000,Clackamas County,Clackamas County-Thurston County-WA
3608,Clackamas County-Ada County-ID-1516,"Ada County, ID",1516,2015,2016,95,4072000,123,4609000,-28,-537000,Clackamas County,Clackamas County-Ada County-ID
3609,Clackamas County-Douglas County-OR-1516,"Douglas County, OR",1516,2015,2016,70,1741000,72,1866000,-2,-125000,Clackamas County,Clackamas County-Douglas County-OR
3610,Clackamas County-Harris County-TX-1516,"Harris County, TX",1516,2015,2016,88,3928000,47,1489000,41,2439000,Clackamas County,Clackamas County-Harris County-TX
3611,Clackamas County-Cowlitz County-WA-1516,"Cowlitz County, WA",1516,2015,2016,69,1634000,79,1958000,-10,-324000,Clackamas County,Clackamas County-Cowlitz County-WA
3612,Clackamas County-Josephine County-OR-1516,"Josephine County, OR",1516,2015,2016,70,1925000,56,1399000,14,526000,Clackamas County,Clackamas County-Josephine County-OR
3613,Clackamas County-Wasco County-OR-1516,"Wasco County, OR",1516,2015,2016,63,1473000,62,1217000,1,256000,Clackamas County,Clackamas County-Wasco County-OR
3614,Clackamas County-Utah County-UT-1516,"Utah County, UT",1516,2015,2016,78,1639000,58,762000,20,877000,Clackamas County,Clackamas County-Utah County-UT
3615,Clackamas County-Umatilla County-OR-1516,"Umatilla County, OR",1516,2015,2016,60,1387000,58,1928000,2,-541000,Clackamas County,Clackamas County-Umatilla County-OR
3616,Clackamas County-Klamath County-OR-1516,"Klamath County, OR",1516,2015,2016,50,1248000,44,1323000,6,-75000,Clackamas County,Clackamas County-Klamath County-OR
3617,Clackamas County-Anchorage Municipality-AK-1516,"Anchorage Municipality, AK",1516,2015,2016,45,1508000,54,1540000,-9,-32000,Clackamas County,Clackamas County-Anchorage Municipality-AK
3618,Clackamas County-Kitsap County-WA-1516,"Kitsap County, WA",1516,2015,2016,43,1249000,32,1719000,11,-470000,Clackamas County,Clackamas County-Kitsap County-WA
3619,Clackamas County-Hood River County-OR-1516,"Hood River County, OR",1516,2015,2016,39,1468000,54,1987000,-15,-519000,Clackamas County,Clackamas County-Hood River County-OR
3620,Clackamas County-Tillamook County-OR-1516,"Tillamook County, OR",1516,2015,2016,42,836000,89,2805000,-47,-1969000,Clackamas County,Clackamas County-Tillamook County-OR
3621,Clackamas County-Washoe County-NV-1516,"Washoe County, NV",1516,2015,2016,37,1590000,33,944000,4,646000,Clackamas County,Clackamas County-Washoe County-NV
3622,Clackamas County-Coos County-OR-1516,"Coos County, OR",1516,2015,2016,42,890000,55,1019000,-13,-129000,Clackamas County,Clackamas County-Coos County-OR
3623,Clackamas County-Crook County-OR-1516,"Crook County, OR",1516,2015,2016,34,962000,80,5328000,-46,-4366000,Clackamas County,Clackamas County-Crook County-OR
3624,Clackamas County-Benton County-WA-1516,"Benton County, WA",1516,2015,2016,37,1198000,54,2075000,-17,-877000,Clackamas County,Clackamas County-Benton County-WA
3626,Clatsop County-Multnomah County-OR-1516,"Multnomah County, OR",1516,2015,2016,232,8003000,146,4359000,86,3644000,Clatsop County,Clatsop County-Multnomah County-OR
3627,Clatsop County-Washington County-OR-1516,"Washington County, OR",1516,2015,2016,197,6372000,160,4655000,37,1717000,Clatsop County,Clatsop County-Washington County-OR
3628,Clatsop County-Clackamas County-OR-1516,"Clackamas County, OR",1516,2015,2016,100,3216000,82,2607000,18,609000,Clatsop County,Clatsop County-Clackamas County-OR
3629,Clatsop County-Columbia County-OR-1516,"Columbia County, OR",1516,2015,2016,83,2385000,66,1353000,17,1032000,Clatsop County,Clatsop County-Columbia County-OR
3630,Clatsop County-Pacific County-WA-1516,"Pacific County, WA",1516,2015,2016,65,973000,70,1294000,-5,-321000,Clatsop County,Clatsop County-Pacific County-WA
3631,Clatsop County-Lane County-OR-1516,"Lane County, OR",1516,2015,2016,51,1185000,41,1385000,10,-200000,Clatsop County,Clatsop County-Lane County-OR
3632,Clatsop County-Tillamook County-OR-1516,"Tillamook County, OR",1516,2015,2016,53,970000,46,1357000,7,-387000,Clatsop County,Clatsop County-Tillamook County-OR
3633,Clatsop County-Clark County-WA-1516,"Clark County, WA",1516,2015,2016,58,1457000,56,1447000,2,10000,Clatsop County,Clatsop County-Clark County-WA
3634,Clatsop County-Marion County-OR-1516,"Marion County, OR",1516,2015,2016,45,1253000,47,1552000,-2,-299000,Clatsop County,Clatsop County-Marion County-OR
3635,Clatsop County-Cowlitz County-WA-1516,"Cowlitz County, WA",1516,2015,2016,30,716000,60,996000,-30,-280000,Clatsop County,Clatsop County-Cowlitz County-WA
3637,Columbia County-Washington County-OR-1516,"Washington County, OR",1516,2015,2016,836,24246000,367,9868000,469,14378000,Columbia County,Columbia County-Washington County-OR
3638,Columbia County-Multnomah County-OR-1516,"Multnomah County, OR",1516,2015,2016,644,18824000,239,5829000,405,12995000,Columbia County,Columbia County-Multnomah County-OR
3639,Columbia County-Clackamas County-OR-1516,"Clackamas County, OR",1516,2015,2016,172,4419000,77,4835000,95,-416000,Columbia County,Columbia County-Clackamas County-OR
3640,Columbia County-Cowlitz County-WA-1516,"Cowlitz County, WA",1516,2015,2016,144,2611000,219,4754000,-75,-2143000,Columbia County,Columbia County-Cowlitz County-WA
3641,Columbia County-Clark County-WA-1516,"Clark County, WA",1516,2015,2016,127,2954000,78,2634000,49,320000,Columbia County,Columbia County-Clark County-WA
3642,Columbia County-Clatsop County-OR-1516,"Clatsop County, OR",1516,2015,2016,66,1353000,83,2385000,-17,-1032000,Columbia County,Columbia County-Clatsop County-OR
3643,Columbia County-Lane County-OR-1516,"Lane County, OR",1516,2015,2016,34,1128000,66,1739000,-32,-611000,Columbia County,Columbia County-Lane County-OR
3645,Coos County-Douglas County-OR-1516,"Douglas County, OR",1516,2015,2016,217,4057000,277,4526000,-60,-469000,Coos County,Coos County-Douglas County-OR
3646,Coos County-Lane County-OR-1516,"Lane County, OR",1516,2015,2016,178,3613000,250,4722000,-72,-1109000,Coos County,Coos County-Lane County-OR
3647,Coos County-Curry County-OR-1516,"Curry County, OR",1516,2015,2016,95,1271000,35,961000,60,310000,Coos County,Coos County-Curry County-OR
3648,Coos County-Jackson County-OR-1516,"Jackson County, OR",1516,2015,2016,83,2008000,96,1718000,-13,290000,Coos County,Coos County-Jackson County-OR
3649,Coos County-Multnomah County-OR-1516,"Multnomah County, OR",1516,2015,2016,66,1656000,83,2212000,-17,-556000,Coos County,Coos County-Multnomah County-OR
3650,Coos County-Washington County-OR-1516,"Washington County, OR",1516,2015,2016,59,1763000,45,1189000,14,574000,Coos County,Coos County-Washington County-OR
3651,Coos County-Marion County-OR-1516,"Marion County, OR",1516,2015,2016,48,980000,76,2121000,-28,-1141000,Coos County,Coos County-Marion County-OR
3652,Coos County-Clackamas County-OR-1516,"Clackamas County, OR",1516,2015,2016,55,1019000,42,890000,13,129000,Coos County,Coos County-Clackamas County-OR
3653,Coos County-Deschutes County-OR-1516,"Deschutes County, OR",1516,2015,2016,43,950000,63,1133000,-20,-183000,Coos County,Coos County-Deschutes County-OR
3654,Coos County-Linn County-OR-1516,"Linn County, OR",1516,2015,2016,37,718000,55,1049000,-18,-331000,Coos County,Coos County-Linn County-OR
3655,Coos County-Josephine County-OR-1516,"Josephine County, OR",1516,2015,2016,42,657000,51,739000,-9,-82000,Coos County,Coos County-Josephine County-OR
3656,Coos County-Clark County-WA-1516,"Clark County, WA",1516,2015,2016,41,910000,54,1235000,-13,-325000,Coos County,Coos County-Clark County-WA
3658,Crook County-Deschutes County-OR-1516,"Deschutes County, OR",1516,2015,2016,587,13198000,313,7467000,274,5731000,Crook County,Crook County-Deschutes County-OR
3659,Crook County-Clackamas County-OR-1516,"Clackamas County, OR",1516,2015,2016,80,5328000,34,962000,46,4366000,Crook County,Crook County-Clackamas County-OR
3660,Crook County-Jefferson County-OR-1516,"Jefferson County, OR",1516,2015,2016,83,1419000,73,1266000,10,153000,Crook County,Crook County-Jefferson County-OR
3662,Curry County-Del Norte County-CA-1516,"Del Norte County, CA",1516,2015,2016,108,3406000,91,1639000,17,1767000,Curry County,Curry County-Del Norte County-CA
3663,Curry County-Jackson County-OR-1516,"Jackson County, OR",1516,2015,2016,95,1680000,82,2519000,13,-839000,Curry County,Curry County-Jackson County-OR
3664,Curry County-Lane County-OR-1516,"Lane County, OR",1516,2015,2016,46,754000,52,582000,-6,172000,Curry County,Curry County-Lane County-OR
3665,Curry County-Coos County-OR-1516,"Coos County, OR",1516,2015,2016,35,961000,95,1271000,-60,-310000,Curry County,Curry County-Coos County-OR
3667,Deschutes County-Multnomah County-OR-1516,"Multnomah County, OR",1516,2015,2016,747,33873000,349,10573000,398,23300000,Deschutes County,Deschutes County-Multnomah County-OR
3668,Deschutes County-Washington County-OR-1516,"Washington County, OR",1516,2015,2016,561,24441000,302,8555000,259,15886000,Deschutes County,Deschutes County-Washington County-OR
3669,Deschutes County-Lane County-OR-1516,"Lane County, OR",1516,2015,2016,536,17250000,346,8029000,190,9221000,Deschutes County,Deschutes County-Lane County-OR
3670,Deschutes County-Clackamas County-OR-1516,"Clackamas County, OR",1516,2015,2016,494,25474000,267,8515000,227,16959000,Deschutes County,Deschutes County-Clackamas County-OR
3671,Deschutes County-Marion County-OR-1516,"Marion County, OR",1516,2015,2016,395,11646000,209,6197000,186,5449000,Deschutes County,Deschutes County-Marion County-OR
3672,Deschutes County-Jefferson County-OR-1516,"Jefferson County, OR",1516,2015,2016,365,8399000,497,9003000,-132,-604000,Deschutes County,Deschutes County-Jefferson County-OR
3673,Deschutes County-Los Angeles County-CA-1516,"Los Angeles County, CA",1516,2015,2016,344,14608000,83,2461000,261,12147000,Deschutes County,Deschutes County-Los Angeles County-CA
3674,Deschutes County-Crook County-OR-1516,"Crook County, OR",1516,2015,2016,313,7467000,587,13198000,-274,-5731000,Deschutes County,Deschutes County-Crook County-OR
3675,Deschutes County-San Diego County-CA-1516,"San Diego County, CA",1516,2015,2016,286,12834000,77,1990000,209,10844000,Deschutes County,Deschutes County-San Diego County-CA
3676,Deschutes County-King County-WA-1516,"King County, WA",1516,2015,2016,277,16438000,107,5824000,170,10614000,Deschutes County,Deschutes County-King County-WA
3677,Deschutes County-Clark County-WA-1516,"Clark County, WA",1516,2015,2016,225,12608000,130,5079000,95,7529000,Deschutes County,Deschutes County-Clark County-WA
3678,Deschutes County-Maricopa County-AZ-1516,"Maricopa County, AZ",1516,2015,2016,179,7226000,199,5730000,-20,1496000,Deschutes County,Deschutes County-Maricopa County-AZ
3679,Deschutes County-Orange County-CA-1516,"Orange County, CA",1516,2015,2016,221,8145000,36,1473000,185,6672000,Deschutes County,Deschutes County-Orange County-CA
3680,Deschutes County-Benton County-OR-1516,"Benton County, OR",1516,2015,2016,162,5674000,86,2238000,76,3436000,Deschutes County,Deschutes County-Benton County-OR
3681,Deschutes County-Jackson County-OR-1516,"Jackson County, OR",1516,2015,2016,170,4483000,194,5050000,-24,-567000,Deschutes County,Deschutes County-Jackson County-OR
3682,Deschutes County-Klamath County-OR-1516,"Klamath County, OR",1516,2015,2016,180,6600000,179,2730000,1,3870000,Deschutes County,Deschutes County-Klamath County-OR
3683,Deschutes County-Linn County-OR-1516,"Linn County, OR",1516,2015,2016,137,3530000,134,2048000,3,1482000,Deschutes County,Deschutes County-Linn County-OR
3684,Deschutes County-Yamhill County-OR-1516,"Yamhill County, OR",1516,2015,2016,121,3042000,65,1937000,56,1105000,Deschutes County,Deschutes County-Yamhill County-OR
3685,Deschutes County-Riverside County-CA-1516,"Riverside County, CA",1516,2015,2016,117,3398000,46,2086000,71,1312000,Deschutes County,Deschutes County-Riverside County-CA
3686,Deschutes County-Polk County-OR-1516,"Polk County, OR",1516,2015,2016,96,3211000,72,1256000,24,1955000,Deschutes County,Deschutes County-Polk County-OR
3687,Deschutes County-Clark County-NV-1516,"Clark County, NV",1516,2015,2016,106,3802000,108,3378000,-2,424000,Deschutes County,Deschutes County-Clark County-NV
3688,Deschutes County-Ada County-ID-1516,"Ada County, ID",1516,2015,2016,82,3251000,96,2499000,-14,752000,Deschutes County,Deschutes County-Ada County-ID
3689,Deschutes County-Lincoln County-OR-1516,"Lincoln County, OR",1516,2015,2016,94,2741000,74,2138000,20,603000,Deschutes County,Deschutes County-Lincoln County-OR
3690,Deschutes County-Douglas County-OR-1516,"Douglas County, OR",1516,2015,2016,83,2038000,95,1923000,-12,115000,Deschutes County,Deschutes County-Douglas County-OR
3691,Deschutes County-Coos County-OR-1516,"Coos County, OR",1516,2015,2016,63,1133000,43,950000,20,183000,Deschutes County,Deschutes County-Coos County-OR
3692,Deschutes County-Pierce County-WA-1516,"Pierce County, WA",1516,2015,2016,55,2285000,51,2863000,4,-578000,Deschutes County,Deschutes County-Pierce County-WA
3693,Deschutes County-Snohomish County-WA-1516,"Snohomish County, WA",1516,2015,2016,68,2756000,42,1622000,26,1134000,Deschutes County,Deschutes County-Snohomish County-WA
3694,Deschutes County-Thurston County-WA-1516,"Thurston County, WA",1516,2015,2016,55,2373000,36,742000,19,1631000,Deschutes County,Deschutes County-Thurston County-WA
3695,Deschutes County-Umatilla County-OR-1516,"Umatilla County, OR",1516,2015,2016,51,2023000,41,837000,10,1186000,Deschutes County,Deschutes County-Umatilla County-OR
3696,Deschutes County-Pima County-AZ-1516,"Pima County, AZ",1516,2015,2016,46,1875000,68,2222000,-22,-347000,Deschutes County,Deschutes County-Pima County-AZ
3698,Douglas County-Lane County-OR-1516,"Lane County, OR",1516,2015,2016,493,9097000,598,15409000,-105,-6312000,Douglas County,Douglas County-Lane County-OR
3699,Douglas County-Coos County-OR-1516,"Coos County, OR",1516,2015,2016,277,4526000,217,4057000,60,469000,Douglas County,Douglas County-Coos County-OR
3700,Douglas County-Jackson County-OR-1516,"Jackson County, OR",1516,2015,2016,136,2403000,193,3517000,-57,-1114000,Douglas County,Douglas County-Jackson County-OR
3701,Douglas County-Washington County-OR-1516,"Washington County, OR",1516,2015,2016,110,2901000,143,5106000,-33,-2205000,Douglas County,Douglas County-Washington County-OR
3702,Douglas County-Multnomah County-OR-1516,"Multnomah County, OR",1516,2015,2016,91,2695000,99,2566000,-8,129000,Douglas County,Douglas County-Multnomah County-OR
3703,Douglas County-Josephine County-OR-1516,"Josephine County, OR",1516,2015,2016,114,1796000,123,2130000,-9,-334000,Douglas County,Douglas County-Josephine County-OR
3704,Douglas County-Deschutes County-OR-1516,"Deschutes County, OR",1516,2015,2016,95,1923000,83,2038000,12,-115000,Douglas County,Douglas County-Deschutes County-OR
3705,Douglas County-Linn County-OR-1516,"Linn County, OR",1516,2015,2016,83,1739000,83,1505000,0,234000,Douglas County,Douglas County-Linn County-OR
3706,Douglas County-Clackamas County-OR-1516,"Clackamas County, OR",1516,2015,2016,72,1866000,70,1741000,2,125000,Douglas County,Douglas County-Clackamas County-OR
3707,Douglas County-Marion County-OR-1516,"Marion County, OR",1516,2015,2016,74,1135000,113,2426000,-39,-1291000,Douglas County,Douglas County-Marion County-OR
3708,Douglas County-Maricopa County-AZ-1516,"Maricopa County, AZ",1516,2015,2016,55,1918000,46,2357000,9,-439000,Douglas County,Douglas County-Maricopa County-AZ
3709,Douglas County-Klamath County-OR-1516,"Klamath County, OR",1516,2015,2016,57,1196000,64,1052000,-7,144000,Douglas County,Douglas County-Klamath County-OR
3710,Douglas County-Clark County-NV-1516,"Clark County, NV",1516,2015,2016,68,1411000,40,935000,28,476000,Douglas County,Douglas County-Clark County-NV
3711,Douglas County-Clark County-WA-1516,"Clark County, WA",1516,2015,2016,53,1280000,62,1375000,-9,-95000,Douglas County,Douglas County-Clark County-WA
3716,Hood River County-Multnomah County-OR-1516,"Multnomah County, OR",1516,2015,2016,170,6432000,157,4371000,13,2061000,Hood River County,Hood River County-Multnomah County-OR
3717,Hood River County-Wasco County-OR-1516,"Wasco County, OR",1516,2015,2016,149,3008000,251,4215000,-102,-1207000,Hood River County,Hood River County-Wasco County-OR
3718,Hood River County-Klickitat County-WA-1516,"Klickitat County, WA",1516,2015,2016,90,2643000,129,5076000,-39,-2433000,Hood River County,Hood River County-Klickitat County-WA
3719,Hood River County-Washington County-OR-1516,"Washington County, OR",1516,2015,2016,63,1945000,40,1001000,23,944000,Hood River County,Hood River County-Washington County-OR
3720,Hood River County-Clackamas County-OR-1516,"Clackamas County, OR",1516,2015,2016,54,1987000,39,1468000,15,519000,Hood River County,Hood River County-Clackamas County-OR
3722,Jackson County-Josephine County-OR-1516,"Josephine County, OR",1516,2015,2016,846,19759000,890,16941000,-44,2818000,Jackson County,Jackson County-Josephine County-OR
3723,Jackson County-Multnomah County-OR-1516,"Multnomah County, OR",1516,2015,2016,260,7561000,330,10361000,-70,-2800000,Jackson County,Jackson County-Multnomah County-OR
3724,Jackson County-Lane County-OR-1516,"Lane County, OR",1516,2015,2016,308,5919000,334,7249000,-26,-1330000,Jackson County,Jackson County-Lane County-OR
3725,Jackson County-Los Angeles County-CA-1516,"Los Angeles County, CA",1516,2015,2016,309,11461000,113,2515000,196,8946000,Jackson County,Jackson County-Los Angeles County-CA
3726,Jackson County-Klamath County-OR-1516,"Klamath County, OR",1516,2015,2016,282,6861000,160,2816000,122,4045000,Jackson County,Jackson County-Klamath County-OR
3727,Jackson County-Washington County-OR-1516,"Washington County, OR",1516,2015,2016,203,6411000,285,9559000,-82,-3148000,Jackson County,Jackson County-Washington County-OR
3728,Jackson County-Deschutes County-OR-1516,"Deschutes County, OR",1516,2015,2016,194,5050000,170,4483000,24,567000,Jackson County,Jackson County-Deschutes County-OR
3729,Jackson County-San Diego County-CA-1516,"San Diego County, CA",1516,2015,2016,191,4524000,74,1881000,117,2643000,Jackson County,Jackson County-San Diego County-CA
3730,Jackson County-Douglas County-OR-1516,"Douglas County, OR",1516,2015,2016,193,3517000,136,2403000,57,1114000,Jackson County,Jackson County-Douglas County-OR
3731,Jackson County-Santa Clara County-CA-1516,"Santa Clara County, CA",1516,2015,2016,141,6149000,28,1505000,113,4644000,Jackson County,Jackson County-Santa Clara County-CA
3732,Jackson County-King County-WA-1516,"King County, WA",1516,2015,2016,118,5416000,126,3612000,-8,1804000,Jackson County,Jackson County-King County-WA
3733,Jackson County-Orange County-CA-1516,"Orange County, CA",1516,2015,2016,148,6926000,38,1263000,110,5663000,Jackson County,Jackson County-Orange County-CA
3734,Jackson County-Shasta County-CA-1516,"Shasta County, CA",1516,2015,2016,152,3352000,55,1018000,97,2334000,Jackson County,Jackson County-Shasta County-CA
3735,Jackson County-Alameda County-CA-1516,"Alameda County, CA",1516,2015,2016,152,7047000,32,1259000,120,5788000,Jackson County,Jackson County-Alameda County-CA
3736,Jackson County-Clackamas County-OR-1516,"Clackamas County, OR",1516,2015,2016,127,2845000,224,9631000,-97,-6786000,Jackson County,Jackson County-Clackamas County-OR
3737,Jackson County-Siskiyou County-CA-1516,"Siskiyou County, CA",1516,2015,2016,122,3030000,79,2241000,43,789000,Jackson County,Jackson County-Siskiyou County-CA
3738,Jackson County-Maricopa County-AZ-1516,"Maricopa County, AZ",1516,2015,2016,132,3776000,124,3671000,8,105000,Jackson County,Jackson County-Maricopa County-AZ
3739,Jackson County-Sacramento County-CA-1516,"Sacramento County, CA",1516,2015,2016,106,3325000,66,1731000,40,1594000,Jackson County,Jackson County-Sacramento County-CA
3740,Jackson County-Contra Costa County-CA-1516,"Contra Costa County, CA",1516,2015,2016,111,5758000,30,751000,81,5007000,Jackson County,Jackson County-Contra Costa County-CA
3741,Jackson County-Marion County-OR-1516,"Marion County, OR",1516,2015,2016,102,2200000,122,2722000,-20,-522000,Jackson County,Jackson County-Marion County-OR
3742,Jackson County-Clark County-NV-1516,"Clark County, NV",1516,2015,2016,100,1885000,70,3014000,30,-1129000,Jackson County,Jackson County-Clark County-NV
3743,Jackson County-Sonoma County-CA-1516,"Sonoma County, CA",1516,2015,2016,94,3240000,53,1459000,41,1781000,Jackson County,Jackson County-Sonoma County-CA
3744,Jackson County-Riverside County-CA-1516,"Riverside County, CA",1516,2015,2016,107,3419000,71,1299000,36,2120000,Jackson County,Jackson County-Riverside County-CA
3745,Jackson County-Curry County-OR-1516,"Curry County, OR",1516,2015,2016,82,2519000,95,1680000,-13,839000,Jackson County,Jackson County-Curry County-OR
3746,Jackson County-Coos County-OR-1516,"Coos County, OR",1516,2015,2016,96,1718000,83,2008000,13,-290000,Jackson County,Jackson County-Coos County-OR
3747,Jackson County-Benton County-OR-1516,"Benton County, OR",1516,2015,2016,74,1778000,59,1436000,15,342000,Jackson County,Jackson County-Benton County-OR
3748,Jackson County-Washoe County-NV-1516,"Washoe County, NV",1516,2015,2016,64,1229000,39,939000,25,290000,Jackson County,Jackson County-Washoe County-NV
3749,Jackson County-Humboldt County-CA-1516,"Humboldt County, CA",1516,2015,2016,61,1533000,29,784000,32,749000,Jackson County,Jackson County-Humboldt County-CA
3750,Jackson County-Clark County-WA-1516,"Clark County, WA",1516,2015,2016,79,1934000,112,3710000,-33,-1776000,Jackson County,Jackson County-Clark County-WA
3751,Jackson County-Pierce County-WA-1516,"Pierce County, WA",1516,2015,2016,73,1542000,79,2478000,-6,-936000,Jackson County,Jackson County-Pierce County-WA
3752,Jackson County-Ada County-ID-1516,"Ada County, ID",1516,2015,2016,54,1587000,67,1382000,-13,205000,Jackson County,Jackson County-Ada County-ID
3753,Jackson County-Linn County-OR-1516,"Linn County, OR",1516,2015,2016,61,1009000,61,890000,0,119000,Jackson County,Jackson County-Linn County-OR
3754,Jackson County-Yamhill County-OR-1516,"Yamhill County, OR",1516,2015,2016,56,1764000,80,1642000,-24,122000,Jackson County,Jackson County-Yamhill County-OR
3755,Jackson County-Pima County-AZ-1516,"Pima County, AZ",1516,2015,2016,35,685000,44,1513000,-9,-828000,Jackson County,Jackson County-Pima County-AZ
3756,Jackson County-Spokane County-WA-1516,"Spokane County, WA",1516,2015,2016,40,1208000,50,1038000,-10,170000,Jackson County,Jackson County-Spokane County-WA
3757,Jackson County-Snohomish County-WA-1516,"Snohomish County, WA",1516,2015,2016,35,617000,36,860000,-1,-243000,Jackson County,Jackson County-Snohomish County-WA
3759,Jefferson County-Deschutes County-OR-1516,"Deschutes County, OR",1516,2015,2016,497,9003000,365,8399000,132,604000,Jefferson County,Jefferson County-Deschutes County-OR
3760,Jefferson County-Crook County-OR-1516,"Crook County, OR",1516,2015,2016,73,1266000,83,1419000,-10,-153000,Jefferson County,Jefferson County-Crook County-OR
3761,Jefferson County-Multnomah County-OR-1516,"Multnomah County, OR",1516,2015,2016,82,1440000,44,632000,38,808000,Jefferson County,Jefferson County-Multnomah County-OR
3763,Josephine County-Jackson County-OR-1516,"Jackson County, OR",1516,2015,2016,890,16941000,846,19759000,44,-2818000,Josephine County,Josephine County-Jackson County-OR
3764,Josephine County-Lane County-OR-1516,"Lane County, OR",1516,2015,2016,125,2184000,161,3232000,-36,-1048000,Josephine County,Josephine County-Lane County-OR
3765,Josephine County-Los Angeles County-CA-1516,"Los Angeles County, CA",1516,2015,2016,114,2709000,49,829000,65,1880000,Josephine County,Josephine County-Los Angeles County-CA
3766,Josephine County-Douglas County-OR-1516,"Douglas County, OR",1516,2015,2016,123,2130000,114,1796000,9,334000,Josephine County,Josephine County-Douglas County-OR
3767,Josephine County-Multnomah County-OR-1516,"Multnomah County, OR",1516,2015,2016,73,690000,73,1791000,0,-1101000,Josephine County,Josephine County-Multnomah County-OR
3768,Josephine County-Washington County-OR-1516,"Washington County, OR",1516,2015,2016,77,1732000,49,1245000,28,487000,Josephine County,Josephine County-Washington County-OR
3769,Josephine County-San Diego County-CA-1516,"San Diego County, CA",1516,2015,2016,82,1623000,38,772000,44,851000,Josephine County,Josephine County-San Diego County-CA
3770,Josephine County-Clark County-NV-1516,"Clark County, NV",1516,2015,2016,65,1250000,50,871000,15,379000,Josephine County,Josephine County-Clark County-NV
3771,Josephine County-Klamath County-OR-1516,"Klamath County, OR",1516,2015,2016,62,1343000,56,1088000,6,255000,Josephine County,Josephine County-Klamath County-OR
3772,Josephine County-Clackamas County-OR-1516,"Clackamas County, OR",1516,2015,2016,56,1399000,70,1925000,-14,-526000,Josephine County,Josephine County-Clackamas County-OR
3773,Josephine County-Marion County-OR-1516,"Marion County, OR",1516,2015,2016,64,1202000,63,1072000,1,130000,Josephine County,Josephine County-Marion County-OR
3774,Josephine County-Coos County-OR-1516,"Coos County, OR",1516,2015,2016,51,739000,42,657000,9,82000,Josephine County,Josephine County-Coos County-OR
3775,Josephine County-Maricopa County-AZ-1516,"Maricopa County, AZ",1516,2015,2016,42,913000,45,1432000,-3,-519000,Josephine County,Josephine County-Maricopa County-AZ
3777,Klamath County-Deschutes County-OR-1516,"Deschutes County, OR",1516,2015,2016,179,2730000,180,6600000,-1,-3870000,Klamath County,Klamath County-Deschutes County-OR
3778,Klamath County-Jackson County-OR-1516,"Jackson County, OR",1516,2015,2016,160,2816000,282,6861000,-122,-4045000,Klamath County,Klamath County-Jackson County-OR
3779,Klamath County-Lane County-OR-1516,"Lane County, OR",1516,2015,2016,128,2472000,114,2304000,14,168000,Klamath County,Klamath County-Lane County-OR
3780,Klamath County-Multnomah County-OR-1516,"Multnomah County, OR",1516,2015,2016,62,2069000,57,1128000,5,941000,Klamath County,Klamath County-Multnomah County-OR
3781,Klamath County-Siskiyou County-CA-1516,"Siskiyou County, CA",1516,2015,2016,113,1185000,91,1097000,22,88000,Klamath County,Klamath County-Siskiyou County-CA
3782,Klamath County-Marion County-OR-1516,"Marion County, OR",1516,2015,2016,61,1247000,56,1060000,5,187000,Klamath County,Klamath County-Marion County-OR
3783,Klamath County-Josephine County-OR-1516,"Josephine County, OR",1516,2015,2016,56,1088000,62,1343000,-6,-255000,Klamath County,Klamath County-Josephine County-OR
3784,Klamath County-Douglas County-OR-1516,"Douglas County, OR",1516,2015,2016,64,1052000,57,1196000,7,-144000,Klamath County,Klamath County-Douglas County-OR
3785,Klamath County-Washington County-OR-1516,"Washington County, OR",1516,2015,2016,53,1320000,109,2621000,-56,-1301000,Klamath County,Klamath County-Washington County-OR
3786,Klamath County-Clackamas County-OR-1516,"Clackamas County, OR",1516,2015,2016,44,1323000,50,1248000,-6,75000,Klamath County,Klamath County-Clackamas County-OR
3789,Lane County-Multnomah County-OR-1516,"Multnomah County, OR",1516,2015,2016,661,15175000,851,27949000,-190,-12774000,Lane County,Lane County-Multnomah County-OR
3790,Lane County-Linn County-OR-1516,"Linn County, OR",1516,2015,2016,634,13123000,816,16896000,-182,-3773000,Lane County,Lane County-Linn County-OR
3791,Lane County-Douglas County-OR-1516,"Douglas County, OR",1516,2015,2016,598,15409000,493,9097000,105,6312000,Lane County,Lane County-Douglas County-OR
3792,Lane County-Washington County-OR-1516,"Washington County, OR",1516,2015,2016,428,11553000,583,15291000,-155,-3738000,Lane County,Lane County-Washington County-OR
3793,Lane County-Marion County-OR-1516,"Marion County, OR",1516,2015,2016,419,11213000,424,9910000,-5,1303000,Lane County,Lane County-Marion County-OR
3794,Lane County-Los Angeles County-CA-1516,"Los Angeles County, CA",1516,2015,2016,426,13901000,145,4225000,281,9676000,Lane County,Lane County-Los Angeles County-CA
3795,Lane County-Benton County-OR-1516,"Benton County, OR",1516,2015,2016,352,9018000,360,8218000,-8,800000,Lane County,Lane County-Benton County-OR
3796,Lane County-Deschutes County-OR-1516,"Deschutes County, OR",1516,2015,2016,346,8029000,536,17250000,-190,-9221000,Lane County,Lane County-Deschutes County-OR
3797,Lane County-Jackson County-OR-1516,"Jackson County, OR",1516,2015,2016,334,7249000,308,5919000,26,1330000,Lane County,Lane County-Jackson County-OR
3798,Lane County-Clackamas County-OR-1516,"Clackamas County, OR",1516,2015,2016,293,7899000,346,13835000,-53,-5936000,Lane County,Lane County-Clackamas County-OR
3799,Lane County-Maricopa County-AZ-1516,"Maricopa County, AZ",1516,2015,2016,290,9088000,156,6482000,134,2606000,Lane County,Lane County-Maricopa County-AZ
3800,Lane County-King County-WA-1516,"King County, WA",1516,2015,2016,278,10491000,296,10730000,-18,-239000,Lane County,Lane County-King County-WA
3801,Lane County-Coos County-OR-1516,"Coos County, OR",1516,2015,2016,250,4722000,178,3613000,72,1109000,Lane County,Lane County-Coos County-OR
3802,Lane County-San Diego County-CA-1516,"San Diego County, CA",1516,2015,2016,221,6258000,138,3063000,83,3195000,Lane County,Lane County-San Diego County-CA
3803,Lane County-Orange County-CA-1516,"Orange County, CA",1516,2015,2016,214,8633000,68,2840000,146,5793000,Lane County,Lane County-Orange County-CA
3804,Lane County-Lincoln County-OR-1516,"Lincoln County, OR",1516,2015,2016,186,4431000,134,3706000,52,725000,Lane County,Lane County-Lincoln County-OR
3805,Lane County-Clark County-WA-1516,"Clark County, WA",1516,2015,2016,178,5010000,213,10739000,-35,-5729000,Lane County,Lane County-Clark County-WA
3806,Lane County-Clark County-NV-1516,"Clark County, NV",1516,2015,2016,179,4757000,113,2144000,66,2613000,Lane County,Lane County-Clark County-NV
3807,Lane County-Josephine County-OR-1516,"Josephine County, OR",1516,2015,2016,161,3232000,125,2184000,36,1048000,Lane County,Lane County-Josephine County-OR
3808,Lane County-Alameda County-CA-1516,"Alameda County, CA",1516,2015,2016,130,5181000,60,2452000,70,2729000,Lane County,Lane County-Alameda County-CA
3809,Lane County-Sacramento County-CA-1516,"Sacramento County, CA",1516,2015,2016,119,4756000,71,1661000,48,3095000,Lane County,Lane County-Sacramento County-CA
3810,Lane County-Contra Costa County-CA-1516,"Contra Costa County, CA",1516,2015,2016,111,4752000,28,776000,83,3976000,Lane County,Lane County-Contra Costa County-CA
3811,Lane County-Santa Clara County-CA-1516,"Santa Clara County, CA",1516,2015,2016,109,6242000,51,1649000,58,4593000,Lane County,Lane County-Santa Clara County-CA
3812,Lane County-Pierce County-WA-1516,"Pierce County, WA",1516,2015,2016,133,3572000,133,3829000,0,-257000,Lane County,Lane County-Pierce County-WA
3813,Lane County-San Bernardino County-CA-1516,"San Bernardino County, CA",1516,2015,2016,133,3031000,37,584000,96,2447000,Lane County,Lane County-San Bernardino County-CA
3814,Lane County-Travis County-TX-1516,"Travis County, TX",1516,2015,2016,122,3143000,52,1179000,70,1964000,Lane County,Lane County-Travis County-TX
3815,Lane County-Klamath County-OR-1516,"Klamath County, OR",1516,2015,2016,114,2304000,128,2472000,-14,-168000,Lane County,Lane County-Klamath County-OR
3816,Lane County-Riverside County-CA-1516,"Riverside County, CA",1516,2015,2016,120,2550000,56,1847000,64,703000,Lane County,Lane County-Riverside County-CA
3817,Lane County-Polk County-OR-1516,"Polk County, OR",1516,2015,2016,96,2246000,117,2469000,-21,-223000,Lane County,Lane County-Polk County-OR
3818,Lane County-Honolulu County-HI-1516,"Honolulu County, HI",1516,2015,2016,86,3620000,46,1075000,40,2545000,Lane County,Lane County-Honolulu County-HI
3819,Lane County-Ada County-ID-1516,"Ada County, ID",1516,2015,2016,113,2739000,85,2647000,28,92000,Lane County,Lane County-Ada County-ID
3820,Lane County-Salt Lake County-UT-1516,"Salt Lake County, UT",1516,2015,2016,95,2409000,67,1229000,28,1180000,Lane County,Lane County-Salt Lake County-UT
3821,Lane County-Sonoma County-CA-1516,"Sonoma County, CA",1516,2015,2016,82,3257000,34,1338000,48,1919000,Lane County,Lane County-Sonoma County-CA
3822,Lane County-Snohomish County-WA-1516,"Snohomish County, WA",1516,2015,2016,95,2450000,90,2213000,5,237000,Lane County,Lane County-Snohomish County-WA
3823,Lane County-Pima County-AZ-1516,"Pima County, AZ",1516,2015,2016,74,1704000,68,2458000,6,-754000,Lane County,Lane County-Pima County-AZ
3824,Lane County-Yamhill County-OR-1516,"Yamhill County, OR",1516,2015,2016,61,1826000,81,1915000,-20,-89000,Lane County,Lane County-Yamhill County-OR
3825,Lane County-San Francisco County-CA-1516,"San Francisco County, CA",1516,2015,2016,55,2709000,28,1030000,27,1679000,Lane County,Lane County-San Francisco County-CA
3826,Lane County-Washoe County-NV-1516,"Washoe County, NV",1516,2015,2016,76,2257000,27,685000,49,1572000,Lane County,Lane County-Washoe County-NV
3827,Lane County-Anchorage Municipality-AK-1516,"Anchorage Municipality, AK",1516,2015,2016,66,2218000,50,1237000,16,981000,Lane County,Lane County-Anchorage Municipality-AK
3828,Lane County-Spokane County-WA-1516,"Spokane County, WA",1516,2015,2016,68,1915000,91,2561000,-23,-646000,Lane County,Lane County-Spokane County-WA
3829,Lane County-Cook County-IL-1516,"Cook County, IL",1516,2015,2016,57,1683000,64,3812000,-7,-2129000,Lane County,Lane County-Cook County-IL
3830,Lane County-Umatilla County-OR-1516,"Umatilla County, OR",1516,2015,2016,59,1315000,71,1165000,-12,150000,Lane County,Lane County-Umatilla County-OR
3831,Lane County-Columbia County-OR-1516,"Columbia County, OR",1516,2015,2016,66,1739000,34,1128000,32,611000,Lane County,Lane County-Columbia County-OR
3832,Lane County-Curry County-OR-1516,"Curry County, OR",1516,2015,2016,52,582000,46,754000,6,-172000,Lane County,Lane County-Curry County-OR
3833,Lane County-Thurston County-WA-1516,"Thurston County, WA",1516,2015,2016,55,1320000,61,1589000,-6,-269000,Lane County,Lane County-Thurston County-WA
3834,Lane County-Clatsop County-OR-1516,"Clatsop County, OR",1516,2015,2016,41,1385000,51,1185000,-10,200000,Lane County,Lane County-Clatsop County-OR
3835,Lane County-Kitsap County-WA-1516,"Kitsap County, WA",1516,2015,2016,45,1211000,49,948000,-4,263000,Lane County,Lane County-Kitsap County-WA
3836,Lane County-Denver County-CO-1516,"Denver County, CO",1516,2015,2016,33,1437000,26,967000,7,470000,Lane County,Lane County-Denver County-CO
3837,Lane County-Yavapai County-AZ-1516,"Yavapai County, AZ",1516,2015,2016,29,1104000,30,1081000,-1,23000,Lane County,Lane County-Yavapai County-AZ
3839,Lincoln County-Multnomah County-OR-1516,"Multnomah County, OR",1516,2015,2016,189,5722000,115,3183000,74,2539000,Lincoln County,Lincoln County-Multnomah County-OR
3840,Lincoln County-Lane County-OR-1516,"Lane County, OR",1516,2015,2016,134,3706000,186,4431000,-52,-725000,Lincoln County,Lincoln County-Lane County-OR
3841,Lincoln County-Washington County-OR-1516,"Washington County, OR",1516,2015,2016,136,5623000,115,2741000,21,2882000,Lincoln County,Lincoln County-Washington County-OR
3842,Lincoln County-Marion County-OR-1516,"Marion County, OR",1516,2015,2016,155,3077000,167,4510000,-12,-1433000,Lincoln County,Lincoln County-Marion County-OR
3843,Lincoln County-Clackamas County-OR-1516,"Clackamas County, OR",1516,2015,2016,139,4392000,82,2417000,57,1975000,Lincoln County,Lincoln County-Clackamas County-OR
3844,Lincoln County-Benton County-OR-1516,"Benton County, OR",1516,2015,2016,119,3482000,126,3732000,-7,-250000,Lincoln County,Lincoln County-Benton County-OR
3845,Lincoln County-Linn County-OR-1516,"Linn County, OR",1516,2015,2016,111,2841000,115,2742000,-4,99000,Lincoln County,Lincoln County-Linn County-OR
3846,Lincoln County-Deschutes County-OR-1516,"Deschutes County, OR",1516,2015,2016,74,2138000,94,2741000,-20,-603000,Lincoln County,Lincoln County-Deschutes County-OR
3847,Lincoln County-Yamhill County-OR-1516,"Yamhill County, OR",1516,2015,2016,70,1849000,64,1042000,6,807000,Lincoln County,Lincoln County-Yamhill County-OR
3848,Lincoln County-Polk County-OR-1516,"Polk County, OR",1516,2015,2016,61,1313000,77,1699000,-16,-386000,Lincoln County,Lincoln County-Polk County-OR
3849,Lincoln County-Tillamook County-OR-1516,"Tillamook County, OR",1516,2015,2016,47,1095000,47,1333000,0,-238000,Lincoln County,Lincoln County-Tillamook County-OR
3850,Lincoln County-Clark County-WA-1516,"Clark County, WA",1516,2015,2016,66,1038000,69,1986000,-3,-948000,Lincoln County,Lincoln County-Clark County-WA
3851,Lincoln County-King County-WA-1516,"King County, WA",1516,2015,2016,34,1778000,27,873000,7,905000,Lincoln County,Lincoln County-King County-WA
3853,Linn County-Benton County-OR-1516,"Benton County, OR",1516,2015,2016,1302,32200000,888,22853000,414,9347000,Linn County,Linn County-Benton County-OR
3854,Linn County-Marion County-OR-1516,"Marion County, OR",1516,2015,2016,1017,22326000,940,22656000,77,-330000,Linn County,Linn County-Marion County-OR
3855,Linn County-Lane County-OR-1516,"Lane County, OR",1516,2015,2016,816,16896000,634,13123000,182,3773000,Linn County,Linn County-Lane County-OR
3856,Linn County-Washington County-OR-1516,"Washington County, OR",1516,2015,2016,224,5450000,126,2973000,98,2477000,Linn County,Linn County-Washington County-OR
3857,Linn County-Multnomah County-OR-1516,"Multnomah County, OR",1516,2015,2016,180,3501000,135,3047000,45,454000,Linn County,Linn County-Multnomah County-OR
3858,Linn County-Polk County-OR-1516,"Polk County, OR",1516,2015,2016,192,4500000,234,4857000,-42,-357000,Linn County,Linn County-Polk County-OR
3859,Linn County-Clackamas County-OR-1516,"Clackamas County, OR",1516,2015,2016,157,4902000,102,2933000,55,1969000,Linn County,Linn County-Clackamas County-OR
3860,Linn County-Deschutes County-OR-1516,"Deschutes County, OR",1516,2015,2016,134,2048000,137,3530000,-3,-1482000,Linn County,Linn County-Deschutes County-OR
3861,Linn County-Lincoln County-OR-1516,"Lincoln County, OR",1516,2015,2016,115,2742000,111,2841000,4,-99000,Linn County,Linn County-Lincoln County-OR
3862,Linn County-Douglas County-OR-1516,"Douglas County, OR",1516,2015,2016,83,1505000,83,1739000,0,-234000,Linn County,Linn County-Douglas County-OR
3863,Linn County-Clark County-WA-1516,"Clark County, WA",1516,2015,2016,84,1732000,62,1614000,22,118000,Linn County,Linn County-Clark County-WA
3864,Linn County-Maricopa County-AZ-1516,"Maricopa County, AZ",1516,2015,2016,55,1432000,35,776000,20,656000,Linn County,Linn County-Maricopa County-AZ
3865,Linn County-Jackson County-OR-1516,"Jackson County, OR",1516,2015,2016,61,890000,61,1009000,0,-119000,Linn County,Linn County-Jackson County-OR
3866,Linn County-Coos County-OR-1516,"Coos County, OR",1516,2015,2016,55,1049000,37,718000,18,331000,Linn County,Linn County-Coos County-OR
3867,Linn County-Yamhill County-OR-1516,"Yamhill County, OR",1516,2015,2016,57,1012000,46,897000,11,115000,Linn County,Linn County-Yamhill County-OR
3868,Linn County-Pierce County-WA-1516,"Pierce County, WA",1516,2015,2016,49,1200000,49,810000,0,390000,Linn County,Linn County-Pierce County-WA
3870,Malheur County-Payette County-ID-1516,"Payette County, ID",1516,2015,2016,331,3850000,320,5756000,11,-1906000,Malheur County,Malheur County-Payette County-ID
3871,Malheur County-Canyon County-ID-1516,"Canyon County, ID",1516,2015,2016,180,2340000,198,3223000,-18,-883000,Malheur County,Malheur County-Canyon County-ID
3872,Malheur County-Ada County-ID-1516,"Ada County, ID",1516,2015,2016,159,1814000,106,2403000,53,-589000,Malheur County,Malheur County-Ada County-ID
3873,Malheur County-Washington County-ID-1516,"Washington County, ID",1516,2015,2016,54,519000,70,1083000,-16,-564000,Malheur County,Malheur County-Washington County-ID
3875,Marion County-Polk County-OR-1516,"Polk County, OR",1516,2015,2016,2127,53265000,2344,51951000,-217,1314000,Marion County,Marion County-Polk County-OR
3876,Marion County-Clackamas County-OR-1516,"Clackamas County, OR",1516,2015,2016,1849,47839000,1167,35079000,682,12760000,Marion County,Marion County-Clackamas County-OR
3877,Marion County-Washington County-OR-1516,"Washington County, OR",1516,2015,2016,1266,31477000,811,23235000,455,8242000,Marion County,Marion County-Washington County-OR
3878,Marion County-Multnomah County-OR-1516,"Multnomah County, OR",1516,2015,2016,1050,26330000,722,21536000,328,4794000,Marion County,Marion County-Multnomah County-OR
3879,Marion County-Linn County-OR-1516,"Linn County, OR",1516,2015,2016,940,22656000,1017,22326000,-77,330000,Marion County,Marion County-Linn County-OR
3880,Marion County-Yamhill County-OR-1516,"Yamhill County, OR",1516,2015,2016,505,11295000,366,9942000,139,1353000,Marion County,Marion County-Yamhill County-OR
3881,Marion County-Lane County-OR-1516,"Lane County, OR",1516,2015,2016,424,9910000,419,11213000,5,-1303000,Marion County,Marion County-Lane County-OR
3882,Marion County-Benton County-OR-1516,"Benton County, OR",1516,2015,2016,309,7653000,217,6184000,92,1469000,Marion County,Marion County-Benton County-OR
3883,Marion County-Clark County-WA-1516,"Clark County, WA",1516,2015,2016,341,7415000,357,7834000,-16,-419000,Marion County,Marion County-Clark County-WA
3884,Marion County-Deschutes County-OR-1516,"Deschutes County, OR",1516,2015,2016,209,6197000,395,11646000,-186,-5449000,Marion County,Marion County-Deschutes County-OR
3885,Marion County-Los Angeles County-CA-1516,"Los Angeles County, CA",1516,2015,2016,226,7175000,100,1809000,126,5366000,Marion County,Marion County-Los Angeles County-CA
3886,Marion County-King County-WA-1516,"King County, WA",1516,2015,2016,182,4976000,170,3807000,12,1169000,Marion County,Marion County-King County-WA
3887,Marion County-Maricopa County-AZ-1516,"Maricopa County, AZ",1516,2015,2016,206,4862000,152,4137000,54,725000,Marion County,Marion County-Maricopa County-AZ
3888,Marion County-Lincoln County-OR-1516,"Lincoln County, OR",1516,2015,2016,167,4510000,155,3077000,12,1433000,Marion County,Marion County-Lincoln County-OR
3889,Marion County-Orange County-CA-1516,"Orange County, CA",1516,2015,2016,146,4082000,49,1141000,97,2941000,Marion County,Marion County-Orange County-CA
3890,Marion County-San Diego County-CA-1516,"San Diego County, CA",1516,2015,2016,142,4022000,91,2000000,51,2022000,Marion County,Marion County-San Diego County-CA
3891,Marion County-Jackson County-OR-1516,"Jackson County, OR",1516,2015,2016,122,2722000,102,2200000,20,522000,Marion County,Marion County-Jackson County-OR
3892,Marion County-Clark County-NV-1516,"Clark County, NV",1516,2015,2016,122,2173000,91,2701000,31,-528000,Marion County,Marion County-Clark County-NV
3893,Marion County-Douglas County-OR-1516,"Douglas County, OR",1516,2015,2016,113,2426000,74,1135000,39,1291000,Marion County,Marion County-Douglas County-OR
3894,Marion County-Riverside County-CA-1516,"Riverside County, CA",1516,2015,2016,99,1908000,48,1159000,51,749000,Marion County,Marion County-Riverside County-CA
3895,Marion County-Pierce County-WA-1516,"Pierce County, WA",1516,2015,2016,68,1690000,79,2182000,-11,-492000,Marion County,Marion County-Pierce County-WA
3896,Marion County-Coos County-OR-1516,"Coos County, OR",1516,2015,2016,76,2121000,48,980000,28,1141000,Marion County,Marion County-Coos County-OR
3897,Marion County-Ada County-ID-1516,"Ada County, ID",1516,2015,2016,70,1971000,80,2335000,-10,-364000,Marion County,Marion County-Ada County-ID
3898,Marion County-Tillamook County-OR-1516,"Tillamook County, OR",1516,2015,2016,61,1387000,83,1605000,-22,-218000,Marion County,Marion County-Tillamook County-OR
3899,Marion County-Spokane County-WA-1516,"Spokane County, WA",1516,2015,2016,69,1471000,81,1734000,-12,-263000,Marion County,Marion County-Spokane County-WA
3900,Marion County-Josephine County-OR-1516,"Josephine County, OR",1516,2015,2016,63,1072000,64,1202000,-1,-130000,Marion County,Marion County-Josephine County-OR
3901,Marion County-Klamath County-OR-1516,"Klamath County, OR",1516,2015,2016,56,1060000,61,1247000,-5,-187000,Marion County,Marion County-Klamath County-OR
3902,Marion County-Umatilla County-OR-1516,"Umatilla County, OR",1516,2015,2016,54,1263000,101,2060000,-47,-797000,Marion County,Marion County-Umatilla County-OR
3903,Marion County-Snohomish County-WA-1516,"Snohomish County, WA",1516,2015,2016,55,1302000,53,1095000,2,207000,Marion County,Marion County-Snohomish County-WA
3904,Marion County-Clatsop County-OR-1516,"Clatsop County, OR",1516,2015,2016,47,1552000,45,1253000,2,299000,Marion County,Marion County-Clatsop County-OR
3905,Marion County-Cowlitz County-WA-1516,"Cowlitz County, WA",1516,2015,2016,50,1198000,49,724000,1,474000,Marion County,Marion County-Cowlitz County-WA
3906,Marion County-Thurston County-WA-1516,"Thurston County, WA",1516,2015,2016,44,1291000,67,2060000,-23,-769000,Marion County,Marion County-Thurston County-WA
3907,Marion County-Canyon County-ID-1516,"Canyon County, ID",1516,2015,2016,41,618000,41,776000,0,-158000,Marion County,Marion County-Canyon County-ID
3909,Morrow County-Umatilla County-OR-1516,"Umatilla County, OR",1516,2015,2016,287,4389000,254,4721000,33,-332000,Morrow County,Morrow County-Umatilla County-OR
3911,Multnomah County-Washington County-OR-1516,"Washington County, OR",1516,2015,2016,6229,302776000,7517,299317000,-1288,3459000,Multnomah County,Multnomah County-Washington County-OR
3912,Multnomah County-Clackamas County-OR-1516,"Clackamas County, OR",1516,2015,2016,6347,197377000,10215,352085000,-3868,-154708000,Multnomah County,Multnomah County-Clackamas County-OR
3913,Multnomah County-Clark County-WA-1516,"Clark County, WA",1516,2015,2016,2859,86378000,5445,146228000,-2586,-59850000,Multnomah County,Multnomah County-Clark County-WA
3914,Multnomah County-Los Angeles County-CA-1516,"Los Angeles County, CA",1516,2015,2016,1287,63703000,629,24302000,658,39401000,Multnomah County,Multnomah County-Los Angeles County-CA
3915,Multnomah County-King County-WA-1516,"King County, WA",1516,2015,2016,1176,61185000,1115,52292000,61,8893000,Multnomah County,Multnomah County-King County-WA
3916,Multnomah County-Lane County-OR-1516,"Lane County, OR",1516,2015,2016,851,27949000,661,15175000,190,12774000,Multnomah County,Multnomah County-Lane County-OR
3917,Multnomah County-San Francisco County-CA-1516,"San Francisco County, CA",1516,2015,2016,895,84916000,198,15375000,697,69541000,Multnomah County,Multnomah County-San Francisco County-CA
3918,Multnomah County-Marion County-OR-1516,"Marion County, OR",1516,2015,2016,722,21536000,1050,26330000,-328,-4794000,Multnomah County,Multnomah County-Marion County-OR
3919,Multnomah County-Alameda County-CA-1516,"Alameda County, CA",1516,2015,2016,668,33960000,186,8567000,482,25393000,Multnomah County,Multnomah County-Alameda County-CA
3920,Multnomah County-San Diego County-CA-1516,"San Diego County, CA",1516,2015,2016,674,24893000,326,11604000,348,13289000,Multnomah County,Multnomah County-San Diego County-CA
3921,Multnomah County-Cook County-IL-1516,"Cook County, IL",1516,2015,2016,552,28968000,188,8062000,364,20906000,Multnomah County,Multnomah County-Cook County-IL
3922,Multnomah County-Maricopa County-AZ-1516,"Maricopa County, AZ",1516,2015,2016,549,19411000,439,15704000,110,3707000,Multnomah County,Multnomah County-Maricopa County-AZ
3923,Multnomah County-Kings County-NY-1516,"Kings County, NY",1516,2015,2016,478,27133000,191,8623000,287,18510000,Multnomah County,Multnomah County-Kings County-NY
3924,Multnomah County-Orange County-CA-1516,"Orange County, CA",1516,2015,2016,434,11818000,185,7058000,249,4760000,Multnomah County,Multnomah County-Orange County-CA
3925,Multnomah County-Travis County-TX-1516,"Travis County, TX",1516,2015,2016,421,17170000,155,6062000,266,11108000,Multnomah County,Multnomah County-Travis County-TX
3926,Multnomah County-Santa Clara County-CA-1516,"Santa Clara County, CA",1516,2015,2016,429,33950000,170,13876000,259,20074000,Multnomah County,Multnomah County-Santa Clara County-CA
3927,Multnomah County-Benton County-OR-1516,"Benton County, OR",1516,2015,2016,331,10217000,249,6611000,82,3606000,Multnomah County,Multnomah County-Benton County-OR
3928,Multnomah County-Jackson County-OR-1516,"Jackson County, OR",1516,2015,2016,330,10361000,260,7561000,70,2800000,Multnomah County,Multnomah County-Jackson County-OR
3929,Multnomah County-Deschutes County-OR-1516,"Deschutes County, OR",1516,2015,2016,349,10573000,747,33873000,-398,-23300000,Multnomah County,Multnomah County-Deschutes County-OR
3930,Multnomah County-Clark County-NV-1516,"Clark County, NV",1516,2015,2016,337,9839000,234,6380000,103,3459000,Multnomah County,Multnomah County-Clark County-NV
3931,Multnomah County-San Mateo County-CA-1516,"San Mateo County, CA",1516,2015,2016,314,23195000,58,4550000,256,18645000,Multnomah County,Multnomah County-San Mateo County-CA
3932,Multnomah County-New York County-NY-1516,"New York County, NY",1516,2015,2016,246,17226000,132,10880000,114,6346000,Multnomah County,Multnomah County-New York County-NY
3933,Multnomah County-Honolulu County-HI-1516,"Honolulu County, HI",1516,2015,2016,294,9816000,112,2808000,182,7008000,Multnomah County,Multnomah County-Honolulu County-HI
3934,Multnomah County-Yamhill County-OR-1516,"Yamhill County, OR",1516,2015,2016,254,8153000,390,13267000,-136,-5114000,Multnomah County,Multnomah County-Yamhill County-OR
3935,Multnomah County-Pierce County-WA-1516,"Pierce County, WA",1516,2015,2016,259,7929000,289,8040000,-30,-111000,Multnomah County,Multnomah County-Pierce County-WA
3936,Multnomah County-Ada County-ID-1516,"Ada County, ID",1516,2015,2016,219,5624000,175,4799000,44,825000,Multnomah County,Multnomah County-Ada County-ID
3937,Multnomah County-Middlesex County-MA-1516,"Middlesex County, MA",1516,2015,2016,199,18857000,85,4576000,114,14281000,Multnomah County,Multnomah County-Middlesex County-MA
3938,Multnomah County-Hennepin County-MN-1516,"Hennepin County, MN",1516,2015,2016,212,10727000,127,4000000,85,6727000,Multnomah County,Multnomah County-Hennepin County-MN
3939,Multnomah County-Salt Lake County-UT-1516,"Salt Lake County, UT",1516,2015,2016,211,7116000,149,5384000,62,1732000,Multnomah County,Multnomah County-Salt Lake County-UT
3940,Multnomah County-Sacramento County-CA-1516,"Sacramento County, CA",1516,2015,2016,210,7273000,170,4183000,40,3090000,Multnomah County,Multnomah County-Sacramento County-CA
3941,Multnomah County-Denver County-CO-1516,"Denver County, CO",1516,2015,2016,205,9157000,139,7447000,66,1710000,Multnomah County,Multnomah County-Denver County-CO
3942,Multnomah County-Contra Costa County-CA-1516,"Contra Costa County, CA",1516,2015,2016,220,19874000,89,3601000,131,16273000,Multnomah County,Multnomah County-Contra Costa County-CA
3943,Multnomah County-Columbia County-OR-1516,"Columbia County, OR",1516,2015,2016,239,5829000,644,18824000,-405,-12995000,Multnomah County,Multnomah County-Columbia County-OR
3944,Multnomah County-Ventura County-CA-1516,"Ventura County, CA",1516,2015,2016,198,7573000,62,1786000,136,5787000,Multnomah County,Multnomah County-Ventura County-CA
3945,Multnomah County-District of Columbia-DC-1516,"District of Columbia, DC",1516,2015,2016,166,10064000,76,5880000,90,4184000,Multnomah County,Multnomah County-District of Columbia-DC
3946,Multnomah County-Harris County-TX-1516,"Harris County, TX",1516,2015,2016,207,9664000,103,3203000,104,6461000,Multnomah County,Multnomah County-Harris County-TX
3947,Multnomah County-Spokane County-WA-1516,"Spokane County, WA",1516,2015,2016,162,4547000,213,5892000,-51,-1345000,Multnomah County,Multnomah County-Spokane County-WA
3948,Multnomah County-Riverside County-CA-1516,"Riverside County, CA",1516,2015,2016,193,4180000,111,3879000,82,301000,Multnomah County,Multnomah County-Riverside County-CA
3949,Multnomah County-Polk County-OR-1516,"Polk County, OR",1516,2015,2016,149,4828000,192,4915000,-43,-87000,Multnomah County,Multnomah County-Polk County-OR
3950,Multnomah County-Sonoma County-CA-1516,"Sonoma County, CA",1516,2015,2016,139,4405000,59,1795000,80,2610000,Multnomah County,Multnomah County-Sonoma County-CA
3951,Multnomah County-Clatsop County-OR-1516,"Clatsop County, OR",1516,2015,2016,146,4359000,232,8003000,-86,-3644000,Multnomah County,Multnomah County-Clatsop County-OR
3952,Multnomah County-Linn County-OR-1516,"Linn County, OR",1516,2015,2016,135,3047000,180,3501000,-45,-454000,Multnomah County,Multnomah County-Linn County-OR
3953,Multnomah County-Dallas County-TX-1516,"Dallas County, TX",1516,2015,2016,164,6924000,77,2967000,87,3957000,Multnomah County,Multnomah County-Dallas County-TX
3954,Multnomah County-Santa Cruz County-CA-1516,"Santa Cruz County, CA",1516,2015,2016,123,4354000,35,1071000,88,3283000,Multnomah County,Multnomah County-Santa Cruz County-CA
3955,Multnomah County-Thurston County-WA-1516,"Thurston County, WA",1516,2015,2016,135,3988000,173,4938000,-38,-950000,Multnomah County,Multnomah County-Thurston County-WA
3956,Multnomah County-Suffolk County-MA-1516,"Suffolk County, MA",1516,2015,2016,114,6773000,62,2727000,52,4046000,Multnomah County,Multnomah County-Suffolk County-MA
3957,Multnomah County-Snohomish County-WA-1516,"Snohomish County, WA",1516,2015,2016,141,4427000,155,4791000,-14,-364000,Multnomah County,Multnomah County-Snohomish County-WA
3958,Multnomah County-Anchorage Municipality-AK-1516,"Anchorage Municipality, AK",1516,2015,2016,143,4905000,65,2004000,78,2901000,Multnomah County,Multnomah County-Anchorage Municipality-AK
3959,Multnomah County-Boulder County-CO-1516,"Boulder County, CO",1516,2015,2016,116,5899000,56,2145000,60,3754000,Multnomah County,Multnomah County-Boulder County-CO
3960,Multnomah County-Hood River County-OR-1516,"Hood River County, OR",1516,2015,2016,157,4371000,170,6432000,-13,-2061000,Multnomah County,Multnomah County-Hood River County-OR
3961,Multnomah County-Pima County-AZ-1516,"Pima County, AZ",1516,2015,2016,119,4645000,117,4583000,2,62000,Multnomah County,Multnomah County-Pima County-AZ
3962,Multnomah County-Philadelphia County-PA-1516,"Philadelphia County, PA",1516,2015,2016,118,5893000,61,1879000,57,4014000,Multnomah County,Multnomah County-Philadelphia County-PA
3963,Multnomah County-Santa Barbara County-CA-1516,"Santa Barbara County, CA",1516,2015,2016,117,4765000,44,1348000,73,3417000,Multnomah County,Multnomah County-Santa Barbara County-CA
3964,Multnomah County-Queens County-NY-1516,"Queens County, NY",1516,2015,2016,99,4576000,34,1351000,65,3225000,Multnomah County,Multnomah County-Queens County-NY
3965,Multnomah County-Lincoln County-OR-1516,"Lincoln County, OR",1516,2015,2016,115,3183000,189,5722000,-74,-2539000,Multnomah County,Multnomah County-Lincoln County-OR
3966,Multnomah County-San Bernardino County-CA-1516,"San Bernardino County, CA",1516,2015,2016,123,2867000,97,2977000,26,-110000,Multnomah County,Multnomah County-San Bernardino County-CA
3967,Multnomah County-Marin County-CA-1516,"Marin County, CA",1516,2015,2016,128,8962000,48,2945000,80,6017000,Multnomah County,Multnomah County-Marin County-CA
3968,Multnomah County-Bernalillo County-NM-1516,"Bernalillo County, NM",1516,2015,2016,131,3420000,70,2573000,61,847000,Multnomah County,Multnomah County-Bernalillo County-NM
3969,Multnomah County-Washoe County-NV-1516,"Washoe County, NV",1516,2015,2016,104,3419000,77,2950000,27,469000,Multnomah County,Multnomah County-Washoe County-NV
3970,Multnomah County-Whatcom County-WA-1516,"Whatcom County, WA",1516,2015,2016,87,1770000,122,3623000,-35,-1853000,Multnomah County,Multnomah County-Whatcom County-WA
3971,Multnomah County-Dane County-WI-1516,"Dane County, WI",1516,2015,2016,96,3401000,40,1736000,56,1665000,Multnomah County,Multnomah County-Dane County-WI
3972,Multnomah County-Cowlitz County-WA-1516,"Cowlitz County, WA",1516,2015,2016,118,4579000,249,5619000,-131,-1040000,Multnomah County,Multnomah County-Cowlitz County-WA
3973,Multnomah County-Montgomery County-MD-1516,"Montgomery County, MD",1516,2015,2016,104,5602000,42,1858000,62,3744000,Multnomah County,Multnomah County-Montgomery County-MD
3974,Multnomah County-Davidson County-TN-1516,"Davidson County, TN",1516,2015,2016,88,3988000,62,2052000,26,1936000,Multnomah County,Multnomah County-Davidson County-TN
3975,Multnomah County-Franklin County-OH-1516,"Franklin County, OH",1516,2015,2016,82,3477000,80,1383000,2,2094000,Multnomah County,Multnomah County-Franklin County-OH
3976,Multnomah County-Douglas County-OR-1516,"Douglas County, OR",1516,2015,2016,99,2566000,91,2695000,8,-129000,Multnomah County,Multnomah County-Douglas County-OR
3977,Multnomah County-Orleans Parish-LA-1516,"Orleans Parish, LA",1516,2015,2016,78,2580000,44,1878000,34,702000,Multnomah County,Multnomah County-Orleans Parish-LA
3978,Multnomah County-Fresno County-CA-1516,"Fresno County, CA",1516,2015,2016,100,2770000,73,1176000,27,1594000,Multnomah County,Multnomah County-Fresno County-CA
3979,Multnomah County-Milwaukee County-WI-1516,"Milwaukee County, WI",1516,2015,2016,82,2735000,31,842000,51,1893000,Multnomah County,Multnomah County-Milwaukee County-WI
3980,Multnomah County-Humboldt County-CA-1516,"Humboldt County, CA",1516,2015,2016,80,1963000,33,704000,47,1259000,Multnomah County,Multnomah County-Humboldt County-CA
3981,Multnomah County-San Luis Obispo County-CA-1516,"San Luis Obispo County, CA",1516,2015,2016,74,2838000,41,1389000,33,1449000,Multnomah County,Multnomah County-San Luis Obispo County-CA
3982,Multnomah County-Fulton County-GA-1516,"Fulton County, GA",1516,2015,2016,91,4744000,41,3296000,50,1448000,Multnomah County,Multnomah County-Fulton County-GA
3983,Multnomah County-Missoula County-MT-1516,"Missoula County, MT",1516,2015,2016,69,1682000,75,2078000,-6,-396000,Multnomah County,Multnomah County-Missoula County-MT
3984,Multnomah County-Tillamook County-OR-1516,"Tillamook County, OR",1516,2015,2016,80,2623000,218,9202000,-138,-6579000,Multnomah County,Multnomah County-Tillamook County-OR
3985,Multnomah County-Bexar County-TX-1516,"Bexar County, TX",1516,2015,2016,83,3133000,51,1430000,32,1703000,Multnomah County,Multnomah County-Bexar County-TX
3986,Multnomah County-Fairfax County-VA-1516,"Fairfax County, VA",1516,2015,2016,85,4500000,53,1609000,32,2891000,Multnomah County,Multnomah County-Fairfax County-VA
3987,Multnomah County-Josephine County-OR-1516,"Josephine County, OR",1516,2015,2016,73,1791000,73,690000,0,1101000,Multnomah County,Multnomah County-Josephine County-OR
3988,Multnomah County-Coos County-OR-1516,"Coos County, OR",1516,2015,2016,83,2212000,66,1656000,17,556000,Multnomah County,Multnomah County-Coos County-OR
3989,Multnomah County-Wasco County-OR-1516,"Wasco County, OR",1516,2015,2016,84,1913000,110,2808000,-26,-895000,Multnomah County,Multnomah County-Wasco County-OR
3990,Multnomah County-Kitsap County-WA-1516,"Kitsap County, WA",1516,2015,2016,76,3764000,82,2946000,-6,818000,Multnomah County,Multnomah County-Kitsap County-WA
3991,Multnomah County-El Paso County-CO-1516,"El Paso County, CO",1516,2015,2016,90,2909000,48,1585000,42,1324000,Multnomah County,Multnomah County-El Paso County-CO
3992,Multnomah County-Kern County-CA-1516,"Kern County, CA",1516,2015,2016,80,3075000,45,929000,35,2146000,Multnomah County,Multnomah County-Kern County-CA
3993,Multnomah County-Allegheny County-PA-1516,"Allegheny County, PA",1516,2015,2016,81,4173000,43,1377000,38,2796000,Multnomah County,Multnomah County-Allegheny County-PA
3994,Multnomah County-Tarrant County-TX-1516,"Tarrant County, TX",1516,2015,2016,78,2570000,102,2433000,-24,137000,Multnomah County,Multnomah County-Tarrant County-TX
3995,Multnomah County-Miami-Dade County-FL-1516,"Miami-Dade County, FL",1516,2015,2016,79,2633000,86,2732000,-7,-99000,Multnomah County,Multnomah County-Miami-Dade County-FL
3996,Multnomah County-Hawaii County-HI-1516,"Hawaii County, HI",1516,2015,2016,66,2551000,76,2095000,-10,456000,Multnomah County,Multnomah County-Hawaii County-HI
3997,Multnomah County-Washtenaw County-MI-1516,"Washtenaw County, MI",1516,2015,2016,71,2602000,34,1220000,37,1382000,Multnomah County,Multnomah County-Washtenaw County-MI
3998,Multnomah County-Shasta County-CA-1516,"Shasta County, CA",1516,2015,2016,69,2095000,35,489000,34,1606000,Multnomah County,Multnomah County-Shasta County-CA
3999,Multnomah County-Orange County-FL-1516,"Orange County, FL",1516,2015,2016,64,2203000,49,1354000,15,849000,Multnomah County,Multnomah County-Orange County-FL
4000,Multnomah County-Pinellas County-FL-1516,"Pinellas County, FL",1516,2015,2016,62,2232000,36,1024000,26,1208000,Multnomah County,Multnomah County-Pinellas County-FL
4001,Multnomah County-Benton County-WA-1516,"Benton County, WA",1516,2015,2016,72,3043000,66,1947000,6,1096000,Multnomah County,Multnomah County-Benton County-WA
4002,Multnomah County-Marion County-IN-1516,"Marion County, IN",1516,2015,2016,62,2869000,25,880000,37,1989000,Multnomah County,Multnomah County-Marion County-IN
4003,Multnomah County-Umatilla County-OR-1516,"Umatilla County, OR",1516,2015,2016,66,1422000,87,1569000,-21,-147000,Multnomah County,Multnomah County-Umatilla County-OR
4004,Multnomah County-Larimer County-CO-1516,"Larimer County, CO",1516,2015,2016,55,1629000,38,1346000,17,283000,Multnomah County,Multnomah County-Larimer County-CO
4005,Multnomah County-Arapahoe County-CO-1516,"Arapahoe County, CO",1516,2015,2016,71,2466000,43,1257000,28,1209000,Multnomah County,Multnomah County-Arapahoe County-CO
4006,Multnomah County-Ramsey County-MN-1516,"Ramsey County, MN",1516,2015,2016,65,4185000,38,1444000,27,2741000,Multnomah County,Multnomah County-Ramsey County-MN
4007,Multnomah County-Buncombe County-NC-1516,"Buncombe County, NC",1516,2015,2016,54,1379000,32,1438000,22,-59000,Multnomah County,Multnomah County-Buncombe County-NC
4008,Multnomah County-Mecklenburg County-NC-1516,"Mecklenburg County, NC",1516,2015,2016,69,3624000,36,1160000,33,2464000,Multnomah County,Multnomah County-Mecklenburg County-NC
4009,Multnomah County-Hillsborough County-FL-1516,"Hillsborough County, FL",1516,2015,2016,59,2022000,47,708000,12,1314000,Multnomah County,Multnomah County-Hillsborough County-FL
4010,Multnomah County-Yakima County-WA-1516,"Yakima County, WA",1516,2015,2016,57,2452000,78,1475000,-21,977000,Multnomah County,Multnomah County-Yakima County-WA
4011,Multnomah County-Monterey County-CA-1516,"Monterey County, CA",1516,2015,2016,55,1884000,29,1429000,26,455000,Multnomah County,Multnomah County-Monterey County-CA
4012,Multnomah County-Chittenden County-VT-1516,"Chittenden County, VT",1516,2015,2016,56,1925000,48,1635000,8,290000,Multnomah County,Multnomah County-Chittenden County-VT
4013,Multnomah County-Jefferson County-CO-1516,"Jefferson County, CO",1516,2015,2016,60,1916000,54,2384000,6,-468000,Multnomah County,Multnomah County-Jefferson County-CO
4014,Multnomah County-DeKalb County-GA-1516,"DeKalb County, GA",1516,2015,2016,60,2503000,29,795000,31,1708000,Multnomah County,Multnomah County-DeKalb County-GA
4015,Multnomah County-Santa Fe County-NM-1516,"Santa Fe County, NM",1516,2015,2016,45,1608000,34,1094000,11,514000,Multnomah County,Multnomah County-Santa Fe County-NM
4016,Multnomah County-Palm Beach County-FL-1516,"Palm Beach County, FL",1516,2015,2016,49,3257000,43,1226000,6,2031000,Multnomah County,Multnomah County-Palm Beach County-FL
4017,Multnomah County-Klamath County-OR-1516,"Klamath County, OR",1516,2015,2016,57,1128000,62,2069000,-5,-941000,Multnomah County,Multnomah County-Klamath County-OR
4018,Multnomah County-Cumberland County-ME-1516,"Cumberland County, ME",1516,2015,2016,44,1322000,37,1344000,7,-22000,Multnomah County,Multnomah County-Cumberland County-ME
4019,Multnomah County-New Haven County-CT-1516,"New Haven County, CT",1516,2015,2016,51,1777000,23,833000,28,944000,Multnomah County,Multnomah County-New Haven County-CT
4020,Multnomah County-Maui County-HI-1516,"Maui County, HI",1516,2015,2016,46,2234000,56,2041000,-10,193000,Multnomah County,Multnomah County-Maui County-HI
4021,Multnomah County-Canyon County-ID-1516,"Canyon County, ID",1516,2015,2016,51,838000,59,1324000,-8,-486000,Multnomah County,Multnomah County-Canyon County-ID
4022,Multnomah County-Gallatin County-MT-1516,"Gallatin County, MT",1516,2015,2016,31,1240000,31,1591000,0,-351000,Multnomah County,Multnomah County-Gallatin County-MT
4023,Multnomah County-Westchester County-NY-1516,"Westchester County, NY",1516,2015,2016,34,3240000,31,2173000,3,1067000,Multnomah County,Multnomah County-Westchester County-NY
4024,Multnomah County-Placer County-CA-1516,"Placer County, CA",1516,2015,2016,34,1450000,35,1425000,-1,25000,Multnomah County,Multnomah County-Placer County-CA
4025,Multnomah County-Kootenai County-ID-1516,"Kootenai County, ID",1516,2015,2016,36,740000,50,885000,-14,-145000,Multnomah County,Multnomah County-Kootenai County-ID
4026,Multnomah County-Skamania County-WA-1516,"Skamania County, WA",1516,2015,2016,49,1079000,81,2557000,-32,-1478000,Multnomah County,Multnomah County-Skamania County-WA
4027,Multnomah County-Jefferson County-OR-1516,"Jefferson County, OR",1516,2015,2016,44,632000,82,1440000,-38,-808000,Multnomah County,Multnomah County-Jefferson County-OR
4028,Multnomah County-Polk County-IA-1516,"Polk County, IA",1516,2015,2016,32,1566000,24,547000,8,1019000,Multnomah County,Multnomah County-Polk County-IA
4029,Multnomah County-Klickitat County-WA-1516,"Klickitat County, WA",1516,2015,2016,33,826000,89,4784000,-56,-3958000,Multnomah County,Multnomah County-Klickitat County-WA
4030,Multnomah County-Knox County-TN-1516,"Knox County, TN",1516,2015,2016,29,1817000,39,1443000,-10,374000,Multnomah County,Multnomah County-Knox County-TN
4031,Multnomah County-Pacific County-WA-1516,"Pacific County, WA",1516,2015,2016,29,1241000,52,2197000,-23,-956000,Multnomah County,Multnomah County-Pacific County-WA
4032,Multnomah County-Walla Walla County-WA-1516,"Walla Walla County, WA",1516,2015,2016,21,697000,33,1185000,-12,-488000,Multnomah County,Multnomah County-Walla Walla County-WA
4034,Polk County-Marion County-OR-1516,"Marion County, OR",1516,2015,2016,2344,51951000,2127,53265000,217,-1314000,Polk County,Polk County-Marion County-OR
4035,Polk County-Yamhill County-OR-1516,"Yamhill County, OR",1516,2015,2016,488,9916000,363,7139000,125,2777000,Polk County,Polk County-Yamhill County-OR
4036,Polk County-Washington County-OR-1516,"Washington County, OR",1516,2015,2016,236,5499000,152,4257000,84,1242000,Polk County,Polk County-Washington County-OR
4037,Polk County-Linn County-OR-1516,"Linn County, OR",1516,2015,2016,234,4857000,192,4500000,42,357000,Polk County,Polk County-Linn County-OR
4038,Polk County-Multnomah County-OR-1516,"Multnomah County, OR",1516,2015,2016,192,4915000,149,4828000,43,87000,Polk County,Polk County-Multnomah County-OR
4039,Polk County-Benton County-OR-1516,"Benton County, OR",1516,2015,2016,154,4810000,143,3627000,11,1183000,Polk County,Polk County-Benton County-OR
4040,Polk County-Clackamas County-OR-1516,"Clackamas County, OR",1516,2015,2016,163,5200000,121,3777000,42,1423000,Polk County,Polk County-Clackamas County-OR
4041,Polk County-Lane County-OR-1516,"Lane County, OR",1516,2015,2016,117,2469000,96,2246000,21,223000,Polk County,Polk County-Lane County-OR
4042,Polk County-Lincoln County-OR-1516,"Lincoln County, OR",1516,2015,2016,77,1699000,61,1313000,16,386000,Polk County,Polk County-Lincoln County-OR
4043,Polk County-King County-WA-1516,"King County, WA",1516,2015,2016,58,2675000,47,1259000,11,1416000,Polk County,Polk County-King County-WA
4044,Polk County-Deschutes County-OR-1516,"Deschutes County, OR",1516,2015,2016,72,1256000,96,3211000,-24,-1955000,Polk County,Polk County-Deschutes County-OR
4045,Polk County-Clark County-WA-1516,"Clark County, WA",1516,2015,2016,59,1208000,78,3383000,-19,-2175000,Polk County,Polk County-Clark County-WA
4048,Tillamook County-Multnomah County-OR-1516,"Multnomah County, OR",1516,2015,2016,218,9202000,80,2623000,138,6579000,Tillamook County,Tillamook County-Multnomah County-OR
4049,Tillamook County-Washington County-OR-1516,"Washington County, OR",1516,2015,2016,170,6244000,91,3281000,79,2963000,Tillamook County,Tillamook County-Washington County-OR
4050,Tillamook County-Clackamas County-OR-1516,"Clackamas County, OR",1516,2015,2016,89,2805000,42,836000,47,1969000,Tillamook County,Tillamook County-Clackamas County-OR
4051,Tillamook County-Marion County-OR-1516,"Marion County, OR",1516,2015,2016,83,1605000,61,1387000,22,218000,Tillamook County,Tillamook County-Marion County-OR
4052,Tillamook County-Clatsop County-OR-1516,"Clatsop County, OR",1516,2015,2016,46,1357000,53,970000,-7,387000,Tillamook County,Tillamook County-Clatsop County-OR
4053,Tillamook County-Lincoln County-OR-1516,"Lincoln County, OR",1516,2015,2016,47,1333000,47,1095000,0,238000,Tillamook County,Tillamook County-Lincoln County-OR
4055,Umatilla County-Walla Walla County-WA-1516,"Walla Walla County, WA",1516,2015,2016,318,4827000,338,5706000,-20,-879000,Umatilla County,Umatilla County-Walla Walla County-WA
4056,Umatilla County-Morrow County-OR-1516,"Morrow County, OR",1516,2015,2016,254,4721000,287,4389000,-33,332000,Umatilla County,Umatilla County-Morrow County-OR
4057,Umatilla County-Benton County-WA-1516,"Benton County, WA",1516,2015,2016,162,2653000,331,6786000,-169,-4133000,Umatilla County,Umatilla County-Benton County-WA
4058,Umatilla County-Multnomah County-OR-1516,"Multnomah County, OR",1516,2015,2016,87,1569000,66,1422000,21,147000,Umatilla County,Umatilla County-Multnomah County-OR
4059,Umatilla County-Union County-OR-1516,"Union County, OR",1516,2015,2016,86,1665000,97,1673000,-11,-8000,Umatilla County,Umatilla County-Union County-OR
4060,Umatilla County-Marion County-OR-1516,"Marion County, OR",1516,2015,2016,101,2060000,54,1263000,47,797000,Umatilla County,Umatilla County-Marion County-OR
4061,Umatilla County-Lane County-OR-1516,"Lane County, OR",1516,2015,2016,71,1165000,59,1315000,12,-150000,Umatilla County,Umatilla County-Lane County-OR
4062,Umatilla County-Clackamas County-OR-1516,"Clackamas County, OR",1516,2015,2016,58,1928000,60,1387000,-2,541000,Umatilla County,Umatilla County-Clackamas County-OR
4063,Umatilla County-Franklin County-WA-1516,"Franklin County, WA",1516,2015,2016,79,929000,157,4067000,-78,-3138000,Umatilla County,Umatilla County-Franklin County-WA
4064,Umatilla County-Washington County-OR-1516,"Washington County, OR",1516,2015,2016,55,1081000,67,1690000,-12,-609000,Umatilla County,Umatilla County-Washington County-OR
4065,Umatilla County-Deschutes County-OR-1516,"Deschutes County, OR",1516,2015,2016,41,837000,51,2023000,-10,-1186000,Umatilla County,Umatilla County-Deschutes County-OR
4066,Umatilla County-Yakima County-WA-1516,"Yakima County, WA",1516,2015,2016,47,367000,89,1466000,-42,-1099000,Umatilla County,Umatilla County-Yakima County-WA
4067,Umatilla County-Spokane County-WA-1516,"Spokane County, WA",1516,2015,2016,30,508000,28,602000,2,-94000,Umatilla County,Umatilla County-Spokane County-WA
4069,Union County-Umatilla County-OR-1516,"Umatilla County, OR",1516,2015,2016,97,1673000,86,1665000,11,8000,Union County,Union County-Umatilla County-OR
4070,Union County-Baker County-OR-1516,"Baker County, OR",1516,2015,2016,93,1284000,109,1655000,-16,-371000,Union County,Union County-Baker County-OR
4071,Union County-Ada County-ID-1516,"Ada County, ID",1516,2015,2016,36,656000,33,732000,3,-76000,Union County,Union County-Ada County-ID
4074,Wasco County-Hood River County-OR-1516,"Hood River County, OR",1516,2015,2016,251,4215000,149,3008000,102,1207000,Wasco County,Wasco County-Hood River County-OR
4075,Wasco County-Multnomah County-OR-1516,"Multnomah County, OR",1516,2015,2016,110,2808000,84,1913000,26,895000,Wasco County,Wasco County-Multnomah County-OR
4076,Wasco County-Klickitat County-WA-1516,"Klickitat County, WA",1516,2015,2016,117,2267000,152,3585000,-35,-1318000,Wasco County,Wasco County-Klickitat County-WA
4077,Wasco County-Clackamas County-OR-1516,"Clackamas County, OR",1516,2015,2016,62,1217000,63,1473000,-1,-256000,Wasco County,Wasco County-Clackamas County-OR
4078,Wasco County-Washington County-OR-1516,"Washington County, OR",1516,2015,2016,50,1473000,38,719000,12,754000,Wasco County,Wasco County-Washington County-OR
4080,Washington County-Multnomah County-OR-1516,"Multnomah County, OR",1516,2015,2016,7517,299317000,6229,302776000,1288,-3459000,Washington County,Washington County-Multnomah County-OR
4081,Washington County-Clackamas County-OR-1516,"Clackamas County, OR",1516,2015,2016,3397,132835000,4079,195470000,-682,-62635000,Washington County,Washington County-Clackamas County-OR
4082,Washington County-Clark County-WA-1516,"Clark County, WA",1516,2015,2016,1361,38037000,2423,70435000,-1062,-32398000,Washington County,Washington County-Clark County-WA
4083,Washington County-Los Angeles County-CA-1516,"Los Angeles County, CA",1516,2015,2016,885,31825000,378,12794000,507,19031000,Washington County,Washington County-Los Angeles County-CA
4084,Washington County-Marion County-OR-1516,"Marion County, OR",1516,2015,2016,811,23235000,1266,31477000,-455,-8242000,Washington County,Washington County-Marion County-OR
4085,Washington County-Yamhill County-OR-1516,"Yamhill County, OR",1516,2015,2016,806,23562000,1830,57094000,-1024,-33532000,Washington County,Washington County-Yamhill County-OR
4086,Washington County-Maricopa County-AZ-1516,"Maricopa County, AZ",1516,2015,2016,812,28010000,621,23092000,191,4918000,Washington County,Washington County-Maricopa County-AZ
4087,Washington County-Lane County-OR-1516,"Lane County, OR",1516,2015,2016,583,15291000,428,11553000,155,3738000,Washington County,Washington County-Lane County-OR
4088,Washington County-King County-WA-1516,"King County, WA",1516,2015,2016,671,31321000,723,32245000,-52,-924000,Washington County,Washington County-King County-WA
4089,Washington County-San Diego County-CA-1516,"San Diego County, CA",1516,2015,2016,517,17862000,291,11641000,226,6221000,Washington County,Washington County-San Diego County-CA
4090,Washington County-Santa Clara County-CA-1516,"Santa Clara County, CA",1516,2015,2016,606,37194000,344,27139000,262,10055000,Washington County,Washington County-Santa Clara County-CA
4091,Washington County-Orange County-CA-1516,"Orange County, CA",1516,2015,2016,472,17330000,181,8701000,291,8629000,Washington County,Washington County-Orange County-CA
4092,Washington County-Benton County-OR-1516,"Benton County, OR",1516,2015,2016,293,8249000,162,3823000,131,4426000,Washington County,Washington County-Benton County-OR
4093,Washington County-Columbia County-OR-1516,"Columbia County, OR",1516,2015,2016,367,9868000,836,24246000,-469,-14378000,Washington County,Washington County-Columbia County-OR
4094,Washington County-Jackson County-OR-1516,"Jackson County, OR",1516,2015,2016,285,9559000,203,6411000,82,3148000,Washington County,Washington County-Jackson County-OR
4095,Washington County-Deschutes County-OR-1516,"Deschutes County, OR",1516,2015,2016,302,8555000,561,24441000,-259,-15886000,Washington County,Washington County-Deschutes County-OR
4096,Washington County-Clark County-NV-1516,"Clark County, NV",1516,2015,2016,324,7855000,265,10075000,59,-2220000,Washington County,Washington County-Clark County-NV
4097,Washington County-Alameda County-CA-1516,"Alameda County, CA",1516,2015,2016,281,11955000,170,7981000,111,3974000,Washington County,Washington County-Alameda County-CA
4098,Washington County-Honolulu County-HI-1516,"Honolulu County, HI",1516,2015,2016,264,6445000,115,3748000,149,2697000,Washington County,Washington County-Honolulu County-HI
4099,Washington County-Pierce County-WA-1516,"Pierce County, WA",1516,2015,2016,245,6542000,212,5501000,33,1041000,Washington County,Washington County-Pierce County-WA
4100,Washington County-Riverside County-CA-1516,"Riverside County, CA",1516,2015,2016,225,5493000,142,3347000,83,2146000,Washington County,Washington County-Riverside County-CA
4101,Washington County-Sacramento County-CA-1516,"Sacramento County, CA",1516,2015,2016,214,7659000,134,5526000,80,2133000,Washington County,Washington County-Sacramento County-CA
4102,Washington County-Cook County-IL-1516,"Cook County, IL",1516,2015,2016,214,9194000,85,3399000,129,5795000,Washington County,Washington County-Cook County-IL
4103,Washington County-Polk County-OR-1516,"Polk County, OR",1516,2015,2016,152,4257000,236,5499000,-84,-1242000,Washington County,Washington County-Polk County-OR
4104,Washington County-Travis County-TX-1516,"Travis County, TX",1516,2015,2016,200,6438000,154,7229000,46,-791000,Washington County,Washington County-Travis County-TX
4105,Washington County-Contra Costa County-CA-1516,"Contra Costa County, CA",1516,2015,2016,159,7212000,95,4316000,64,2896000,Washington County,Washington County-Contra Costa County-CA
4106,Washington County-Spokane County-WA-1516,"Spokane County, WA",1516,2015,2016,169,4094000,173,5347000,-4,-1253000,Washington County,Washington County-Spokane County-WA
4107,Washington County-Clatsop County-OR-1516,"Clatsop County, OR",1516,2015,2016,160,4655000,197,6372000,-37,-1717000,Washington County,Washington County-Clatsop County-OR
4108,Washington County-Harris County-TX-1516,"Harris County, TX",1516,2015,2016,158,6256000,100,2577000,58,3679000,Washington County,Washington County-Harris County-TX
4109,Washington County-Salt Lake County-UT-1516,"Salt Lake County, UT",1516,2015,2016,168,4398000,147,3428000,21,970000,Washington County,Washington County-Salt Lake County-UT
4110,Washington County-Douglas County-OR-1516,"Douglas County, OR",1516,2015,2016,143,5106000,110,2901000,33,2205000,Washington County,Washington County-Douglas County-OR
4111,Washington County-Ada County-ID-1516,"Ada County, ID",1516,2015,2016,148,5260000,214,8321000,-66,-3061000,Washington County,Washington County-Ada County-ID
4112,Washington County-Snohomish County-WA-1516,"Snohomish County, WA",1516,2015,2016,133,4707000,247,7891000,-114,-3184000,Washington County,Washington County-Snohomish County-WA
4113,Washington County-Linn County-OR-1516,"Linn County, OR",1516,2015,2016,126,2973000,224,5450000,-98,-2477000,Washington County,Washington County-Linn County-OR
4114,Washington County-San Francisco County-CA-1516,"San Francisco County, CA",1516,2015,2016,130,6965000,37,2453000,93,4512000,Washington County,Washington County-San Francisco County-CA
4115,Washington County-San Mateo County-CA-1516,"San Mateo County, CA",1516,2015,2016,149,10545000,59,5150000,90,5395000,Washington County,Washington County-San Mateo County-CA
4116,Washington County-Thurston County-WA-1516,"Thurston County, WA",1516,2015,2016,122,4773000,93,3238000,29,1535000,Washington County,Washington County-Thurston County-WA
4117,Washington County-Lincoln County-OR-1516,"Lincoln County, OR",1516,2015,2016,115,2741000,136,5623000,-21,-2882000,Washington County,Washington County-Lincoln County-OR
4118,Washington County-San Bernardino County-CA-1516,"San Bernardino County, CA",1516,2015,2016,137,3060000,88,2007000,49,1053000,Washington County,Washington County-San Bernardino County-CA
4119,Washington County-Ventura County-CA-1516,"Ventura County, CA",1516,2015,2016,124,3205000,50,1592000,74,1613000,Washington County,Washington County-Ventura County-CA
4120,Washington County-Pima County-AZ-1516,"Pima County, AZ",1516,2015,2016,109,3411000,85,5428000,24,-2017000,Washington County,Washington County-Pima County-AZ
4121,Washington County-Dallas County-TX-1516,"Dallas County, TX",1516,2015,2016,122,5508000,91,4653000,31,855000,Washington County,Washington County-Dallas County-TX
4122,Washington County-Bernalillo County-NM-1516,"Bernalillo County, NM",1516,2015,2016,123,4734000,46,1454000,77,3280000,Washington County,Washington County-Bernalillo County-NM
4123,Washington County-Tillamook County-OR-1516,"Tillamook County, OR",1516,2015,2016,91,3281000,170,6244000,-79,-2963000,Washington County,Washington County-Tillamook County-OR
4124,Washington County-Klamath County-OR-1516,"Klamath County, OR",1516,2015,2016,109,2621000,53,1320000,56,1301000,Washington County,Washington County-Klamath County-OR
4125,Washington County-Anchorage Municipality-AK-1516,"Anchorage Municipality, AK",1516,2015,2016,92,3663000,35,793000,57,2870000,Washington County,Washington County-Anchorage Municipality-AK
4126,Washington County-Washoe County-NV-1516,"Washoe County, NV",1516,2015,2016,100,3140000,93,2494000,7,646000,Washington County,Washington County-Washoe County-NV
4127,Washington County-Middlesex County-MA-1516,"Middlesex County, MA",1516,2015,2016,117,4935000,76,4437000,41,498000,Washington County,Washington County-Middlesex County-MA
4128,Washington County-Hennepin County-MN-1516,"Hennepin County, MN",1516,2015,2016,114,5356000,61,2028000,53,3328000,Washington County,Washington County-Hennepin County-MN
4129,Washington County-Benton County-WA-1516,"Benton County, WA",1516,2015,2016,93,2292000,90,3087000,3,-795000,Washington County,Washington County-Benton County-WA
4130,Washington County-Utah County-UT-1516,"Utah County, UT",1516,2015,2016,123,2774000,135,3522000,-12,-748000,Washington County,Washington County-Utah County-UT
4131,Washington County-Cowlitz County-WA-1516,"Cowlitz County, WA",1516,2015,2016,82,1481000,150,3307000,-68,-1826000,Washington County,Washington County-Cowlitz County-WA
4132,Washington County-Kitsap County-WA-1516,"Kitsap County, WA",1516,2015,2016,87,2405000,68,2285000,19,120000,Washington County,Washington County-Kitsap County-WA
4133,Washington County-Sonoma County-CA-1516,"Sonoma County, CA",1516,2015,2016,70,2005000,40,1020000,30,985000,Washington County,Washington County-Sonoma County-CA
4134,Washington County-Yakima County-WA-1516,"Yakima County, WA",1516,2015,2016,82,1860000,76,1609000,6,251000,Washington County,Washington County-Yakima County-WA
4135,Washington County-El Paso County-CO-1516,"El Paso County, CO",1516,2015,2016,73,1869000,58,2125000,15,-256000,Washington County,Washington County-El Paso County-CO
4136,Washington County-Monterey County-CA-1516,"Monterey County, CA",1516,2015,2016,65,2028000,37,1236000,28,792000,Washington County,Washington County-Monterey County-CA
4137,Washington County-Umatilla County-OR-1516,"Umatilla County, OR",1516,2015,2016,67,1690000,55,1081000,12,609000,Washington County,Washington County-Umatilla County-OR
4138,Washington County-Franklin County-OH-1516,"Franklin County, OH",1516,2015,2016,62,2489000,61,1572000,1,917000,Washington County,Washington County-Franklin County-OH
4139,Washington County-Josephine County-OR-1516,"Josephine County, OR",1516,2015,2016,49,1245000,77,1732000,-28,-487000,Washington County,Washington County-Josephine County-OR
4140,Washington County-Arapahoe County-CO-1516,"Arapahoe County, CO",1516,2015,2016,65,1564000,77,2413000,-12,-849000,Washington County,Washington County-Arapahoe County-CO
4141,Washington County-Bexar County-TX-1516,"Bexar County, TX",1516,2015,2016,63,1630000,74,3107000,-11,-1477000,Washington County,Washington County-Bexar County-TX
4142,Washington County-Tarrant County-TX-1516,"Tarrant County, TX",1516,2015,2016,55,1557000,61,2029000,-6,-472000,Washington County,Washington County-Tarrant County-TX
4143,Washington County-Whatcom County-WA-1516,"Whatcom County, WA",1516,2015,2016,49,1362000,48,1394000,1,-32000,Washington County,Washington County-Whatcom County-WA
4144,Washington County-Placer County-CA-1516,"Placer County, CA",1516,2015,2016,74,3287000,56,2205000,18,1082000,Washington County,Washington County-Placer County-CA
4145,Washington County-Denver County-CO-1516,"Denver County, CO",1516,2015,2016,56,2589000,58,2556000,-2,33000,Washington County,Washington County-Denver County-CO
4146,Washington County-Canyon County-ID-1516,"Canyon County, ID",1516,2015,2016,54,665000,59,1561000,-5,-896000,Washington County,Washington County-Canyon County-ID
4147,Washington County-Coos County-OR-1516,"Coos County, OR",1516,2015,2016,45,1189000,59,1763000,-14,-574000,Washington County,Washington County-Coos County-OR
4148,Washington County-Williamson County-TX-1516,"Williamson County, TX",1516,2015,2016,49,2439000,127,5354000,-78,-2915000,Washington County,Washington County-Williamson County-TX
4149,Washington County-Miami-Dade County-FL-1516,"Miami-Dade County, FL",1516,2015,2016,52,1359000,29,795000,23,564000,Washington County,Washington County-Miami-Dade County-FL
4150,Washington County-Collin County-TX-1516,"Collin County, TX",1516,2015,2016,69,2524000,120,3768000,-51,-1244000,Washington County,Washington County-Collin County-TX
4151,Washington County-Hawaii County-HI-1516,"Hawaii County, HI",1516,2015,2016,40,1195000,47,2559000,-7,-1364000,Washington County,Washington County-Hawaii County-HI
4152,Washington County-Allegheny County-PA-1516,"Allegheny County, PA",1516,2015,2016,44,1738000,48,1462000,-4,276000,Washington County,Washington County-Allegheny County-PA
4153,Washington County-Kootenai County-ID-1516,"Kootenai County, ID",1516,2015,2016,45,1172000,58,1357000,-13,-185000,Washington County,Washington County-Kootenai County-ID
4154,Washington County-Hood River County-OR-1516,"Hood River County, OR",1516,2015,2016,40,1001000,63,1945000,-23,-944000,Washington County,Washington County-Hood River County-OR
4155,Washington County-Wasco County-OR-1516,"Wasco County, OR",1516,2015,2016,38,719000,50,1473000,-12,-754000,Washington County,Washington County-Wasco County-OR
4156,Washington County-Davis County-UT-1516,"Davis County, UT",1516,2015,2016,71,1681000,61,1768000,10,-87000,Washington County,Washington County-Davis County-UT
4157,Washington County-Pinal County-AZ-1516,"Pinal County, AZ",1516,2015,2016,60,1592000,53,2318000,7,-726000,Washington County,Washington County-Pinal County-AZ
4158,Washington County-Orange County-FL-1516,"Orange County, FL",1516,2015,2016,39,1303000,36,1310000,3,-7000,Washington County,Washington County-Orange County-FL
4159,Washington County-Solano County-CA-1516,"Solano County, CA",1516,2015,2016,45,1550000,40,820000,5,730000,Washington County,Washington County-Solano County-CA
4160,Washington County-Oakland County-MI-1516,"Oakland County, MI",1516,2015,2016,48,1403000,41,1484000,7,-81000,Washington County,Washington County-Oakland County-MI
4163,Yamhill County-Washington County-OR-1516,"Washington County, OR",1516,2015,2016,1830,57094000,806,23562000,1024,33532000,Yamhill County,Yamhill County-Washington County-OR
4164,Yamhill County-Clackamas County-OR-1516,"Clackamas County, OR",1516,2015,2016,445,12484000,357,12186000,88,298000,Yamhill County,Yamhill County-Clackamas County-OR
4165,Yamhill County-Multnomah County-OR-1516,"Multnomah County, OR",1516,2015,2016,390,13267000,254,8153000,136,5114000,Yamhill County,Yamhill County-Multnomah County-OR
4166,Yamhill County-Marion County-OR-1516,"Marion County, OR",1516,2015,2016,366,9942000,505,11295000,-139,-1353000,Yamhill County,Yamhill County-Marion County-OR
4167,Yamhill County-Polk County-OR-1516,"Polk County, OR",1516,2015,2016,363,7139000,488,9916000,-125,-2777000,Yamhill County,Yamhill County-Polk County-OR
4168,Yamhill County-Clark County-WA-1516,"Clark County, WA",1516,2015,2016,115,2408000,160,4935000,-45,-2527000,Yamhill County,Yamhill County-Clark County-WA
4169,Yamhill County-Lane County-OR-1516,"Lane County, OR",1516,2015,2016,81,1915000,61,1826000,20,89000,Yamhill County,Yamhill County-Lane County-OR
4170,Yamhill County-King County-WA-1516,"King County, WA",1516,2015,2016,58,2356000,31,761000,27,1595000,Yamhill County,Yamhill County-King County-WA
4171,Yamhill County-Los Angeles County-CA-1516,"Los Angeles County, CA",1516,2015,2016,68,2021000,34,788000,34,1233000,Yamhill County,Yamhill County-Los Angeles County-CA
4172,Yamhill County-Deschutes County-OR-1516,"Deschutes County, OR",1516,2015,2016,65,1937000,121,3042000,-56,-1105000,Yamhill County,Yamhill County-Deschutes County-OR
4173,Yamhill County-Jackson County-OR-1516,"Jackson County, OR",1516,2015,2016,80,1642000,56,1764000,24,-122000,Yamhill County,Yamhill County-Jackson County-OR
4174,Yamhill County-Lincoln County-OR-1516,"Lincoln County, OR",1516,2015,2016,64,1042000,70,1849000,-6,-807000,Yamhill County,Yamhill County-Lincoln County-OR
4175,Yamhill County-Benton County-OR-1516,"Benton County, OR",1516,2015,2016,51,1412000,36,596000,15,816000,Yamhill County,Yamhill County-Benton County-OR
4176,Yamhill County-Linn County-OR-1516,"Linn County, OR",1516,2015,2016,46,897000,57,1012000,-11,-115000,Yamhill County,Yamhill County-Linn County-OR
4177,Yamhill County-Maricopa County-AZ-1516,"Maricopa County, AZ",1516,2015,2016,30,1010000,57,1560000,-27,-550000,Yamhill County,Yamhill County-Maricopa County-AZ
